"id";"countyfips";"year";"births";"censusbuildingpermits";"deaths";"groupquarterspopulation";"householdpopulation";"households";"householdsize";"naturalincrease";"netmigration";"totalhousingunits";"vacancyrate";"vacanthousingunits";"totalpopulation"
1;0;1985;55115;30898;20234;81139;3133309;1221557;2.565012;34881;5317;1402558;12.91;181001;3214448
2;0;1986;55142;30280;20768;82109;3161694;1243453;2.542673;34374;-5731;1436610;13.45;193157;3243803
3;0;1987;53803;17449;21089;83419;3179935;1258199;2.52737;32714;-14299;1467981;14.29;209782;3263354
4;0;1988;53346;12371;21312;86810;3184638;1267288;2.512955;32034;-24046;1486346;14.74;219058;3271448
5;0;1989;52697;10740;21056;87671;3196866;1282386;2.492905;31641;-18698;1497046;14.34;214660;3284537
6;0;1990;53491;11388;21514;79551;3224491;1282488;2.514246;31977;-12584;1477349;13.19;194861;3304042
7;0;1991;53530;13450;22096;81719;3299232;1313504;2.511779;31434;45475;1488886;11.78;175382;3380951
8;0;1992;54545;23057;22426;84669;3405163;1354139;2.514633;32119;76762;1503198;9.92;149059;3489832
9;0;1993;54100;29791;23171;89323;3515715;1386998;2.534766;30929;84277;1527392;9.19;140394;3605038
10;0;1994;53788;36748;23828;90658;3621404;1418294;2.553352;29960;77064;1557549;8.94;139255;3712062
11;0;1995;53869;38618;24724;93604;3717470;1451449;2.561213;29145;69867;1594454;8.97;143005;3811074
12;0;1996;54974;41135;25083;99958;3802490;1483877;2.562537;29891;61483;1634373;9.21;150496;3902448
13;0;1997;56305;43052;25885;96858;3899065;1527884;2.551938;30420;63055;1675928;8.83;148044;3995923
14;0;1998;57738;51156;26297;99083;4003408;1560722;2.5651;31441;75127;1719248;9.22;158526;4102491
15;0;1999;60718;49313;26532;106333;4109651;1607300;2.556866;34186;79307;1779663;9.69;172363;4215984
16;0;2000;63917;54596;26997;102749;4236052;1674523;2.529706669;36920;85875;1835015;8.75;160492;4338801
17;0;2001;66525;52872;27934;104464;4340049;1717669;2.52670858;38591;67121;1888179;9.03;170510;4444513
18;0;2002;67778;53348;28833;105962;4398747;1743164;2.523429836;38945;21251;1940772;10.18;197610;4504709
19;0;2003;69012;46521;28950;106969;4448115;1764982;2.520201316;40062;10313;1991916;11.39;226932;4555084
20;0;2004;68452;38609;29025;108262;4500549;1788148;2.516877238;39427;14300;2034030;12.09;245882;4608811
21;0;2005;69031;45307;29087;108525;4554009;1811477;2.513975612;39944;13779;2080634;12.94;269157;4662534
22;0;2006;69538;44188;29308;111028;4634632;1845956;2.510694729;40230;42896;2122727;13.04;276771;4745660
23;0;2007;70777;36353;29653;111911;4709873;1879158;2.506375465;41124;35000;2159545;12.98;280388;4821784
24;0;2008;70733;27917;31048;112860;4789078;1914596;2.501351721;39685;40469;2184314;12.35;269718;4901938
25;0;2009;69135;18191;30487;113459;4863394;1947695;2.497001069;38648;36267;2203007;11.59;255313;4976853
26;0;2010;67306;2338.75;31396;116952;4933380;1980978;2.490500429;35910;37569;2218388;10.7;237410;5050332
27;0;2011;65923;11914.81;32017;117986;5005706;2009805;2.490765316;33906;39454;2230249;9.88;220444;5123692
28;0;2012;64733;12556.09;32764;116930;5079013;2039021;2.490907646;31969;40282;2242840;9.09;203819;5195943
29;0;2013;64735;23687.57;33624;117855;5155087;2068052;2.492726005;31111;45888;2265415;8.71;197363;5272942
30;0;2014;65711;27874.08;34003;117692;5235174;2097570;2.49582684;31708;48216;2291673;8.47;194103;5352866
31;0;2015;66339;29549.56;36244;119884;5334823;2131796;2.502501646;30095;71746;2320388;8.13;188592;5454707
32;0;2016;66561;32015.9;36820;119832;5423119;2162942;2.507270833;29741;58503;2348706;7.91;185764;5542951
33;0;2017;65312;37493.16;37747;121328;5495239;2194022;2.504720475;27565;46051;2384579;7.99;190557;5616567
34;0;2018;63780;40673;38219;121558;5572753;2225211;2.504465138;25561;52183;2425438;8.26;200227;5694311
35;1;1985;5210;2741;1304;2256;266508;94949;2.806854;3906;-807;104376;9.03;9427;268764
36;1;1986;5101;2926;1425;2254;266389;95759;2.781869;3676;-3797;108677;11.89;12918;268643
37;1;1987;5058;943;1540;2261;267062;96564;2.765648;3518;-2838;111852;13.67;15288;269323
38;1;1988;5024;432;1486;2187;266832;97064;2.749032;3538;-3842;112933;14.05;15869;269019
39;1;1989;4777;397;1429;2249;264522;96879;2.730437;3348;-5596;113086;14.33;16207;266771
40;1;1990;4807;335;1561;2727;262981;96353;2.729349;3246;-4309;106947;9.91;10594;265708
41;1;1991;4940;658;1639;2776;270848;98326;2.754592;3301;4615;107282;8.35;8956;273624
42;1;1992;5005;1385;1619;2844;278541;101116;2.754668;3386;4375;108074;6.44;6958;281385
43;1;1993;5034;2439;1693;2880;287897;102836;2.799574;3341;6051;109367;5.97;6531;290777
44;1;1994;4906;2906;1800;2963;297831;105211;2.830797;3106;6911;111800;5.89;6589;300794
45;1;1995;5063;2944;1781;2979;309614;108485;2.85398;3282;8517;114742;5.45;6257;312593
46;1;1996;5251;2764;1844;3774;319268;111208;2.870908;3407;7042;117691;5.51;6483;323042
47;1;1997;5480;4155;1872;3798;328946;114514;2.87254;3608;6094;120682;5.11;6168;332744
48;1;1998;5846;4478;2053;3795;340229;117449;2.896823;3793;7487;124925;5.98;7476;344024
49;1;1999;6155;4146;2081;3792;351516;120316;2.921607;4074;7210;129403;7.02;9087;355308
50;1;2000;6869;1455;2115;3414;348321;124088;2.807048224;4754;-8328;128717;3.6;4629;351735
51;1;2001;7132;5819;2223;3396;356041;126724;2.809578296;4909;2793;133917;5.37;7193;359437
52;1;2002;7271;6158;2213;3625;367556;130680;2.812641567;5058;6686;139734;6.48;9054;371181
53;1;2003;7393;5981;2283;3649;374016;132793;2.816534004;5110;1374;144635;8.19;11842;377665
54;1;2004;7429;4811;2216;3643;382302;135443;2.822604343;5213;3067;149648;9.49;14205;385945
55;1;2005;7560;5313;2357;3626;391758;138478;2.829026993;5203;4236;154113;10.15;15635;395384
56;1;2006;7733;4928;2241;3657;403930;142496;2.834676061;5492;6711;157948;9.78;15452;407587
57;1;2007;7841;3252;2279;3671;412244;145208;2.838989587;5562;2766;160651;9.61;15443;415915
58;1;2008;7925;2288;2448;3683;421455;148306;2.841793319;5477;3746;162115;8.52;13809;425138
59;1;2009;7699;957;2359;3873;432450;152045;2.84422375;5340;5845;162794;6.6;10749;436323
60;1;2010;7436;130.85;2474;4027;439684;154505;2.845759037;4962;2426;163435;5.46;8930;443711
61;1;2011;7247;663.97;2467;4042;448152;157460;2.846132351;4780;3703;164066;4.03;6606;452194
62;1;2012;6923;716.23;2754;4019;456562;160393;2.846520733;4169;4218;164805;2.68;4412;460581
63;1;2013;7171;1266.8;2798;4029;466052;163736;2.846362437;4373;5127;165879;1.29;2143;470081
64;1;2014;7044;1541;2711;4135;476079;165363;2.878993487;4333;5800;167270;1.14;1907;480214
65;1;2015;7361;1573.33;2962;4130;486558;165297;2.943537995;4399;6075;168727;2.03;3430;490688
66;1;2016;7171;1448.97;2942;4301;493822;165697;2.980271218;4229;3206;170048;2.56;4351;498123
67;1;2017;7167;2502.18;3113;4273;499790;168930;2.958562718;4054;1886;172767;2.22;3837;504063
68;1;2018;6916;2730.76;3128;4273;507196;172120;2.946758076;3788;3618;175672;2.02;3552;511469
69;3;1985;258;10;79;884;12127;4277;2.835399;179;-85;5113;16.35;836;13011
70;3;1986;246;16;84;897;12439;4388;2.834777;162;163;5117;14.25;729;13336
71;3;1987;273;11;90;900;12527;4412;2.839302;183;-92;5126;13.93;714;13427
72;3;1988;264;60;99;1168;12547;4394;2.855485;165;123;5147;14.63;753;13715
73;3;1989;234;28;103;1153;12507;4375;2.858743;131;-186;5293;17.34;918;13660
74;3;1990;265;29;91;998;12632;4721;2.675704;174;-204;5254;10.14;533;13630
75;3;1991;273;20;95;967;12672;4860;2.607407;178;-169;5283;8.01;423;13639
76;3;1992;273;33;84;1063;12509;4931;2.536808;189;-256;5303;7.01;372;13572
77;3;1993;228;73;98;817;12840;4983;2.576761;130;-45;5357;6.98;374;13657
78;3;1994;218;45;98;550;13273;5147;2.578784;120;46;5430;5.21;283;13823
79;3;1995;230;9;126;929;13168;5200;2.532308;104;170;5475;5.02;275;14097
80;3;1996;236;68;119;795;13527;5391;2.509182;117;108;5651;4.6;260;14322
81;3;1997;235;89;124;876;13602;5500;2.473091;111;45;5719;3.83;219;14478
82;3;1998;242;100;100;916;13707;5603;2.446368;142;3;5808;3.53;205;14623
83;3;1999;203;78;114;956;13866;5700;2.432631;89;110;6019;5.3;319;14822
84;3;2000;231;13;106;995;14104;5523;2.553684592;125;149;6146;10.14;623;15099
85;3;2001;249;52;113;995;14236;5598;2.54305109;136;-4;6200;9.71;602;15231
86;3;2002;227;92;116;995;14271;5636;2.532114975;111;-76;6246;9.77;610;15266
87;3;2003;220;48;131;995;14365;5697;2.521502545;89;5;6299;9.56;602;15360
88;3;2004;271;35;101;995;14411;5741;2.510189862;170;-124;6350;9.59;609;15406
89;3;2005;260;53;115;995;14400;5757;2.501302762;145;-156;6392;9.93;635;15395
90;3;2006;227;64;93;995;14355;5761;2.491754904;134;-179;6417;10.22;656;15350
91;3;2007;263;48;114;995;14298;5763;2.480999479;149;-206;6462;10.82;699;15293
92;3;2008;258;54;109;995;14351;5808;2.470902204;149;-96;6510;10.78;702;15346
93;3;2009;272;56;89;995;14306;5814;2.460612315;183;-228;6536;11.05;722;15301
94;3;2010;250;7.5;127;740;14734;6008;2.452396804;123;50;6561;8.43;553;15474
95;3;2011;234;38;131;740;14926;6085;2.452917009;103;89;6598;7.78;513;15666
96;3;2012;208;53;118;740;14902;6077;2.452196808;90;-114;6650;8.62;573;15642
97;3;2013;223;73;146;740;15009;6121;2.452050319;77;30;6722;8.94;601;15749
98;3;2014;240;50;126;865;14906;6078;2.452451464;114;-92;6776;10.3;698;15771
99;3;2015;215;56;128;865;15004;6118;2.452435436;87;11;6843;10.59;725;15869
100;3;2016;200;26;141;865;15155;6180;2.452265372;59;92;6879;10.16;699;16020
101;3;2017;197;75;157;865;15206;6203;2.451394487;40;11;6960;10.88;757;16071
102;3;2018;200;69;138;865;15316;6249;2.450952152;62;48;7032;11.13;783;16181
103;5;1985;6458;5069;1602;3536;377708;140787;2.682833;4856;9246;153726;8.42;12939;381244
104;5;1986;6414;4020;1693;3586;383658;144013;2.664051;4721;1279;159313;9.6;15300;387244
105;5;1987;6269;2060;1665;3604;385083;145014;2.655488;4604;-3161;163322;11.21;18308;388687
106;5;1988;6269;1804;1723;3787;382936;144805;2.644494;4546;-6510;165411;12.46;20606;386723
107;5;1989;6200;558;1712;3666;385836;146698;2.630138;4488;-1709;166846;12.08;20148;389502
108;5;1990;6163;637;1829;3112;390172;154710;2.521957;4334;-552;168665;8.27;13955;393284
109;5;1991;6404;1027;1909;3207;399995;159542;2.507145;4495;5423;169302;5.76;9760;403202
110;5;1992;6551;2277;1970;3311;414370;165029;2.510892;4581;9898;170329;3.11;5300;417681
111;5;1993;6407;2905;2036;3383;424087;168215;2.521101;4371;5418;172532;2.5;4317;427470
112;5;1994;6250;4198;2223;3196;433209;171232;2.529953;4027;4908;175437;2.4;4205;436405
113;5;1995;6231;3408;2289;3211;439328;173806;2.527692;3942;2192;179635;3.24;5829;442539
114;5;1996;6343;3585;2281;3190;447875;177697;2.520442;4062;4464;183260;3.04;5563;451065
115;5;1997;6166;3932;2475;2265;456793;182703;2.500194;3691;4302;186853;2.22;4150;459058
116;5;1998;6504;4234;2534;2243;470156;187217;2.511289;3970;9371;190785;1.87;3568;472399
117;5;1999;6905;5437;2641;3283;478023;191571;2.495279;4264;4643;195845;2.18;4274;481306
118;5;2000;7111;1725;2711;4847;485875;192016;2.530388093;4400;5015;198605;3.32;6589;490722
119;5;2001;7526;6900;2909;5193;496478;196308;2.529076757;4617;6332;202264;2.94;5956;501671
120;5;2002;7553;7017;2932;5406;505097;199890;2.526874781;4621;4211;208601;4.18;8711;510503
121;5;2003;8031;3915;2914;5621;510733;202072;2.527480304;5117;734;213840;5.5;11768;516354
122;5;2004;8013;2727;2884;5851;517864;204867;2.527805845;5129;2232;217147;5.66;12280;523715
123;5;2005;8088;3070;3014;5643;522571;206663;2.528614217;5074;-575;221982;6.9;15319;528214
124;5;2006;8036;3162;2934;5433;530618;209780;2.529402231;5102;2735;226156;7.24;16376;536051
125;5;2007;8233;2711;3118;5917;539965;213407;2.530212224;5115;4716;230285;7.33;16878;545882
126;5;2008;8292;3023;3207;5773;550473;217507;2.530828893;5085;5279;233100;6.69;15593;556246
127;5;2009;8124;1445;3182;5605;560875;220854;2.539573655;4942;5292;236200;6.5;15346;566480
128;5;2010;7981;278.35;3295;4920;569899;225114;2.531601766;4686;3653;238847;5.75;13733;574819
129;5;2011;7707;1254.13;3422;4797;581086;229541;2.531512889;4285;6779;240179;4.43;10638;585883
130;5;2012;7747;333.56;3382;4764;591720;233822;2.530642968;4365;6236;240688;2.85;6866;596484
131;5;2013;7821;1318.4;3555;4547;603734;237527;2.541748938;4266;7531;242184;1.92;4657;608281
132;5;2014;7906;2749.85;3487;4526;614352;241408;2.544870095;4419;6178;245028;1.48;3620;618878
133;5;2015;8130;1457.69;3750;4323;626378;244699;2.559789783;4380;7443;246825;0.86;2126;630701
134;5;2016;8094;2015.81;3925;4275;634395;246119;2.577594578;4169;3800;248668;1.03;2549;638670
135;5;2017;7855;4311.29;3957;4275;640010;250210;2.557891371;3898;1717;252944;1.08;2734;644285
136;5;2018;7687;2534.61;3973;4275;647070;253318;2.554378291;3714;3346;255424;0.82;2106;651345
137;7;1985;101;9;22;0;5213;1837;2.837779;79;149;3379;45.63;1542;5213
138;7;1986;96;121;40;0;5335;1896;2.813818;56;66;3635;47.84;1739;5335
139;7;1987;88;104;30;0;5265;1884;2.794586;58;-128;3869;51.31;1985;5265
140;7;1988;91;116;42;0;5004;1802;2.776915;49;-310;3979;54.71;2177;5004
141;7;1989;84;68;35;0;5196;1885;2.756499;49;143;4082;53.82;2197;5196
142;7;1990;85;72;30;0;5393;2010;2.683084;55;142;3951;49.13;1941;5393
143;7;1991;73;63;36;0;5626;2076;2.710019;37;196;4023;48.4;1947;5626
144;7;1992;70;107;25;0;5880;2147;2.738705;45;209;4086;47.45;1939;5880
145;7;1993;62;101;35;0;6177;2324;2.657917;27;270;4193;44.57;1869;6177
146;7;1994;77;189;34;0;6539;2456;2.662459;43;319;4294;42.8;1838;6539
147;7;1995;61;248;36;0;7108;2671;2.661175;25;544;4483;40.42;1812;7108
148;7;1996;77;249;36;0;7928;2987;2.654168;41;779;4731;36.86;1744;7928
149;7;1997;99;243;48;0;8534;3239;2.634764;51;555;4980;34.96;1741;8534
150;7;1998;84;308;41;0;9133;3452;2.645713;43;556;5223;33.91;1771;9133
151;7;1999;106;271;56;0;9570;3619;2.644377;50;387;5536;34.63;1917;9570
152;7;2000;104;87;56;84;9959;4047;2.460835187;48;425;6302;35.78;2255;10043
153;7;2001;112;350;60;84;10381;4252;2.441439323;52;370;6667;36.22;2415;10465
154;7;2002;126;284;58;84;10616;4384;2.421532847;68;167;6967;37.07;2583;10700
155;7;2003;118;365;57;84;10880;4529;2.402296313;61;203;7350;38.38;2821;10964
156;7;2004;129;213;64;84;11087;4654;2.382251826;65;142;7582;38.62;2928;11171
157;7;2005;109;234;62;84;11318;4790;2.362839248;47;184;7836;38.87;3046;11402
158;7;2006;105;247;62;84;11714;4999;2.343268654;43;353;8104;38.31;3105;11798
159;7;2007;150;302;78;84;12024;5173;2.324376571;72;238;8428;38.62;3255;12108
160;7;2008;130;202;76;84;11990;5204;2.303996925;54;-88;8652;39.85;3448;12074
161;7;2009;111;147;94;84;11815;5171;2.284857861;17;-192;8714;40.66;3543;11899
162;7;2010;108;10.5;63;129;11931;5257;2.269545368;45;116;8772;40.07;3515;12060
163;7;2011;137;37;82;129;11905;5245;2.269780744;55;-81;8818;40.52;3573;12034
164;7;2012;116;36;72;129;12018;5295;2.269688385;44;69;8870;40.3;3575;12147
165;7;2013;106;53;92;129;12104;5332;2.270067517;14;72;8929;40.28;3597;12233
166;7;2014;109;70;94;129;12121;5340;2.269850187;15;2;9015;40.77;3675;12250
167;7;2015;118;75;101;129;12282;5411;2.269820736;17;144;9095;40.51;3684;12411
168;7;2016;117;113;91;129;12719;5603;2.27003391;26;411;9204;39.12;3601;12848
169;7;2017;136;131;107;129;13197;5814;2.269865841;29;449;9337;37.73;3523;13326
170;7;2018;118;173;105;129;13617;5999;2.269878313;13;407;9519;36.98;3520;13746
171;9;1985;83;1;62;0;4873;1867;2.61007;21;-195;2581;27.66;714;4873
172;9;1986;57;0;56;0;4587;1768;2.594457;1;-287;2603;32.08;835;4587
173;9;1987;74;1;48;0;4559;1763;2.585933;26;-54;2625;32.84;862;4559
174;9;1988;76;1;64;0;4728;1836;2.575163;12;157;2630;30.19;794;4728
175;9;1989;51;3;52;0;4629;1807;2.561704;-1;-98;2587;30.15;780;4629
176;9;1990;61;1;58;74;4452;1872;2.378205;3;-106;2434;23.09;562;4526
177;9;1991;55;3;49;70;4371;1787;2.445999;6;-91;2435;26.61;648;4441
178;9;1992;42;4;58;71;4231;1794;2.358417;-16;-123;2438;26.42;644;4302
179;9;1993;33;3;56;71;4255;1776;2.395833;-23;47;2442;27.27;666;4326
180;9;1994;54;7;54;71;4320;1790;2.413408;0;65;2445;26.79;655;4391
181;9;1995;44;4;56;72;4356;1808;2.409292;-12;49;2452;26.26;644;4428
182;9;1996;58;5;58;74;4452;1855;2.4;0;98;2456;24.47;601;4526
183;9;1997;49;10;58;74;4488;1884;2.382166;-9;45;2461;23.45;577;4562
184;9;1998;53;18;69;74;4457;1873;2.379605;-16;-15;2471;24.2;598;4531
185;9;1999;42;10;63;74;4449;1873;2.375334;-21;13;2489;24.75;616;4523
186;9;2000;55;2;74;85;4414;1901;2.321935823;-19;-4;2360;19.45;459;4499
187;9;2001;41;7;67;85;4362;1888;2.310381356;-26;-26;2352;19.73;464;4447
188;9;2002;40;7;64;85;4230;1841;2.297664313;-24;-108;2342;21.39;501;4315
189;9;2003;35;7;62;85;4173;1827;2.28407225;-27;-30;2333;21.69;506;4258
190;9;2004;26;10;53;85;4081;1795;2.273537604;-27;-65;2327;22.86;532;4166
191;9;2005;38;9;56;85;4013;1780;2.254494382;-18;-50;2317;23.18;537;4098
192;9;2006;37;1;62;85;4003;1784;2.243834081;-25;15;2301;22.47;517;4088
193;9;2007;44;0;70;85;3908;1752;2.230593607;-26;-69;2287;23.39;535;3993
194;9;2008;45;1;62;85;3821;1721;2.220220802;-17;-70;2273;24.29;552;3906
195;9;2009;38;0;69;85;3729;1689;2.207815275;-31;-61;2257;25.17;568;3814
196;9;2010;39;0.25;52;82;3713;1687;2.200948429;-13;-6;2248;24.96;561;3795
197;9;2011;41;2;73;82;3687;1679;2.19594997;-32;6;2250;25.38;571;3769
198;9;2012;53;2;72;82;3629;1650;2.199393939;-19;-39;2252;26.73;602;3711
199;9;2013;48;0;54;82;3565;1621;2.199259716;-6;-58;2252;28.02;631;3647
200;9;2014;37;0;49;82;3496;1588;2.201511335;-12;-57;2252;29.48;664;3578
201;9;2015;32;0;56;82;3464;1574;2.200762389;-24;-8;2252;30.11;678;3546
202;9;2016;38;0;63;82;3442;1567;2.196553925;-25;3;2252;30.42;685;3524
203;9;2017;39;1;45;82;3460;1521;2.274819198;-6;24;2253;32.49;732;3542
204;9;2018;35;0;61;82;3465;1575;2.2;-26;31;2253;30.09;678;3547
205;11;1985;80;6;64;424;5275;1986;2.656093;16;-155;2532;21.56;546;5699
206;11;1986;56;2;66;427;5302;2013;2.63388;-10;40;2548;21;535;5729
207;11;1987;65;7;55;407;5025;1923;2.613105;10;-307;2561;24.91;638;5432
208;11;1988;76;3;71;405;5027;1938;2.593911;5;-5;2571;24.62;633;5432
209;11;1989;64;1;48;331;4879;1895;2.57467;16;-238;2574;26.38;679;5210
210;11;1990;60;2;67;372;4655;1865;2.495979;-7;-176;2332;20.03;467;5027
211;11;1991;59;1;66;366;4594;1836;2.502179;-7;-60;2334;21.34;498;4960
212;11;1992;48;2;51;369;4671;1853;2.520777;-3;83;2335;20.64;482;5040
213;11;1993;63;5;43;603;4747;1914;2.480146;20;290;2337;18.1;423;5350
214;11;1994;59;12;45;709;4691;1896;2.474156;14;36;2342;19.04;446;5400
215;11;1995;78;19;74;735;4814;1954;2.463664;4;145;2354;16.99;400;5549
216;11;1996;70;52;73;1072;4551;1865;2.440214;-3;77;2373;21.41;508;5623
217;11;1997;56;15;70;1479;4161;1730;2.405202;-14;31;2425;28.66;695;5640
218;11;1998;72;23;74;1846;4147;1734;2.39158;-2;355;2440;28.93;706;5993
219;11;1999;82;14;62;2213;3783;1591;2.37775;20;-17;2463;35.4;872;5996
220;11;2000;66;4;65;926;5041;1994;2.528084253;1;-35;2365;15.69;371;5967
221;11;2001;69;17;64;878;5004;1995;2.508270677;5;-90;2362;15.54;367;5882
222;11;2002;66;12;78;1067;5136;2063;2.489578284;-12;333;2353;12.32;290;6203
223;11;2003;62;11;66;1408;5245;2123;2.470560528;-4;454;2343;9.39;220;6653
224;11;2004;63;0;64;1505;4852;1979;2.451743305;-1;-295;2323;14.81;344;6357
225;11;2005;63;10;49;1565;4696;1931;2.43190057;14;-110;2312;16.48;381;6261
226;11;2006;60;9;72;1553;4523;1874;2.413553895;-12;-173;2300;18.52;426;6076
227;11;2007;68;4;56;1525;4248;1773;2.395939086;12;-315;2285;22.41;512;5773
228;11;2008;64;7;73;1760;4248;1789;2.3745109;-9;244;2271;21.22;482;6008
229;11;2009;63;5;69;2216;4265;1810;2.356353591;-6;479;2255;19.73;445;6481
230;11;2010;54;0.75;58;2208;4298;1835;2.342234332;-4;29;2243;18.19;408;6506
231;11;2011;44;5;60;2114;4221;1802;2.342397336;-16;-155;2248;19.84;446;6335
232;11;2012;55;1;60;1686;4140;1767;2.34295416;-5;-504;2250;21.47;483;5826
233;11;2013;38;1;62;1715;4029;1720;2.34244186;-24;-58;2254;23.69;534;5744
234;11;2014;32;2;49;1869;3906;1668;2.341726619;-17;48;2256;26.06;588;5775
235;11;2015;42;0;55;1907;3964;1693;2.341405789;-13;109;2256;24.96;563;5871
236;11;2016;34;4;61;1735;3903;1666;2.342737095;-27;-206;2260;26.28;594;5638
237;11;2017;42;2;72;1934;3901;1666;2.341536615;-30;227;2262;26.35;596;5835
238;11;2018;30;3;83;1932;3889;1661;2.341360626;-53;39;2265;26.67;604;5821
239;13;1985;3326;1953;1064;8600;200844;79100;2.539115;2262;-3005;88178;10.3;9078;209444
240;13;1986;3272;1944;1007;8729;203112;80731;2.515911;2265;132;90087;10.39;9356;211841
241;13;1987;3251;1626;1061;8780;205442;82203;2.499203;2190;191;92060;10.71;9857;214222
242;13;1988;3231;925;1071;9384;208996;84226;2.481372;2160;1998;93728;10.14;9502;218380
243;13;1989;3230;1056;1065;10854;211500;85911;2.46185;2165;1809;94466;9.06;8555;222354
244;13;1990;3320;1375;1094;8640;217374;88402;2.458926;2226;1434;94621;6.57;6219;226014
245;13;1991;3323;1478;1104;9097;221880;89867;2.468982;2219;2744;96048;6.44;6181;230977
246;13;1992;3332;2734;1043;9266;229131;93100;2.461128;2289;5131;97631;4.64;4531;238397
247;13;1993;3228;2684;1191;9561;237714;96796;2.455825;2037;6841;100204;3.4;3408;247275
248;13;1994;3166;2191;1205;9469;243256;98566;2.46795;1961;3489;102888;4.2;4322;252725
249;13;1995;3050;2938;1281;9606;247894;100377;2.46963;1769;3006;105055;4.45;4678;257500
250;13;1996;3199;2588;1242;9561;252204;102053;2.471304;1957;2308;107800;5.33;5747;261765
251;13;1997;3182;3062;1352;9328;256735;104480;2.457265;1830;2468;110475;5.43;5995;266063
252;13;1998;3377;4687;1343;9514;264601;107096;2.47069;2034;6018;113224;5.41;6128;274115
253;13;1999;3513;2780;1369;9700;274224;109720;2.499307;2144;7665;117952;6.98;8232;283924
254;13;2000;3719;621;1388;8506;267749;109578;2.443455803;2331;-10004;114121;3.98;4543;276255
255;13;2001;3833;2483;1444;8794;274716;112448;2.443049232;2389;4866;116588;3.55;4140;283510
256;13;2002;3829;2230;1403;8906;275527;112904;2.440365266;2426;-1503;118445;4.68;5541;284433
257;13;2003;3636;1775;1474;8883;273880;112395;2.436763201;2162;-3832;120272;6.55;7877;282763
258;13;2004;3571;1606;1434;8600;274688;112905;2.432912626;2137;-1612;121715;7.24;8810;283288
259;13;2005;3510;1771;1378;8562;274348;112978;2.42833118;2132;-2510;123133;8.25;10155;282910
260;13;2006;3511;1427;1471;9931;276202;113945;2.423994032;2040;1183;124311;8.34;10366;286133
261;13;2007;3390;953;1481;9809;278948;115320;2.41890392;1909;715;125261;7.94;9941;288757
262;13;2008;3353;701;1524;9935;281892;116788;2.413706888;1829;1241;125999;7.31;9211;291827
263;13;2009;3187;1044;1512;9879;283762;117841;2.4080074;1675;139;126756;7.03;8915;293641
264;13;2010;3141;97.5;1544;9396;286209;119566;2.393732332;1597;367;127182;5.99;7616;295605
265;13;2011;2995;700;1510;9717;290491;121380;2.393236118;1485;3118;128006;5.18;6626;300208
266;13;2012;2954;785.53;1571;10034;295271;123358;2.393610467;1383;3714;128687;4.14;5329;305305
267;13;2013;2963;1388.37;1666;10319;299739;125197;2.394138837;1297;3456;130032;3.72;4835;310058
268;13;2014;2939;1677;1709;10603;302505;126388;2.393462987;1230;1820;131558;3.93;5170;313108
269;13;2015;2857;1464.4;1784;10977;308032;128626;2.39478799;1073;4828;132824;3.16;4198;319009
270;13;2016;2841;1437;1813;10905;311380;129944;2.396263006;1028;2248;134176;3.15;4232;322285
271;13;2017;2628;1877.08;1790;10966;312501;130376;2.396921212;838;344;135961;4.11;5585;323467
272;13;2018;2580;1948.49;1832;11006;314474;131050;2.399648989;748;1265;137473;4.67;6423;325480
273;14;1985;0;0;0;0;0;0;0;0;0;0;0;0;0
274;14;1986;0;0;0;0;0;0;0;0;0;0;0;0;0
275;14;1987;0;0;0;0;0;0;0;0;0;0;0;0;0
276;14;1988;0;0;0;0;0;0;0;0;0;0;0;0;0
277;14;1989;0;0;0;0;0;0;0;0;0;0;0;0;0
278;14;1990;0;0;0;0;0;0;0;0;0;0;0;0;0
279;14;1991;0;0;0;0;0;0;0;0;0;0;0;0;0
280;14;1992;0;0;0;0;0;0;0;0;0;0;0;0;0
281;14;1993;0;0;0;0;0;0;0;0;0;0;0;0;0
282;14;1994;0;0;0;0;0;0;0;0;0;0;0;0;0
283;14;1995;0;0;0;0;0;0;0;0;0;0;0;0;0
284;14;1996;0;0;0;0;0;0;0;0;0;0;0;0;0
285;14;1997;0;0;0;0;0;0;0;0;0;0;0;0;0
286;14;1998;0;0;0;0;0;0;0;0;0;0;0;0;0
287;14;1999;0;0;0;0;0;0;0;0;0;0;0;0;0
288;14;2000;0;112;0;7;38537;13949;2.762707004;0;38544;14450;3.47;501;38544
289;14;2001;0;446;0;7;41380;15071;2.745670493;0;2843;15056;-0.1;-15;41387
290;14;2002;421;1070;116;7;42425;15548;2.728646771;305;740;15881;2.1;333;42432
291;14;2003;689;856;190;7;44953;16578;2.711605743;499;2029;16800;1.32;222;44960
292;14;2004;604;621;208;7;46399;17219;2.694639642;396;1050;17548;1.87;329;46406
293;14;2005;649;715;193;7;48244;18018;2.677544678;456;1389;18778;4.05;760;48251
294;14;2006;676;742;228;7;51145;19223;2.660614888;448;2453;19729;2.56;506;51152
295;14;2007;722;1027;231;7;53321;20170;2.643579574;491;1685;20727;2.69;557;53328
296;14;2008;723;1006;230;7;54393;20709;2.626539186;493;579;21472;3.55;763;54400
297;14;2009;693;794;244;7;55371;21219;2.609500919;449;529;22327;4.96;1108;55378
298;14;2010;690;40;271;282;55825;21498;2.596753186;419;310;22685;5.23;1187;56107
299;14;2011;682;232;316;282;57092;21986;2.596743382;366;901;22910;4.03;924;57374
300;14;2012;673;229;318;282;58578;22558;2.596772764;355;1131;23134;2.49;576;58860
301;14;2013;684;2010;323;282;59773;23018;2.596793814;361;834;25103;8.31;2085;60055
302;14;2014;699;896;347;282;61390;23641;2.596759866;352;1265;25980;9;2339;61672
303;14;2015;671;1067;358;282;64483;24832;2.596770296;313;2780;27021;8.1;2189;64765
304;14;2016;735;709;377;282;66122;25463;2.596787496;358;1281;27713;8.12;2250;66404
305;14;2017;673;779;352;282;67828;26120;2.596784074;321;1385;28483;8.3;2363;68110
306;14;2018;634;416;373;644;68809;26498;2.59676202;261;1082;28902;8.32;2404;69453
307;15;1985;156;73;107;612;11737;4543;2.583535;49;-538;6402;29.04;1859;12349
308;15;1986;169;39;136;620;11853;4617;2.567251;33;91;6473;28.67;1856;12473
309;15;1987;129;49;107;620;11833;4632;2.55462;22;-42;6511;28.86;1879;12453
310;15;1988;148;58;120;923;11467;4434;2.586153;28;-91;6572;32.53;2138;12390
311;15;1989;132;42;121;1128;11431;4532;2.522286;11;158;6575;31.07;2043;12559
312;15;1990;133;36;107;1158;11548;4848;2.382013;26;121;6547;25.95;1699;12706
313;15;1991;125;104;117;1230;11634;5027;2.314303;8;150;6583;23.64;1556;12864
314;15;1992;112;83;155;1288;11833;5108;2.316562;-43;300;6687;23.61;1579;13121
315;15;1993;128;117;142;1535;12165;5176;2.350271;-14;593;6770;23.55;1594;13700
316;15;1994;127;182;157;1314;12793;5438;2.352519;-30;437;6887;21.04;1449;14107
317;15;1995;115;211;121;1248;13408;5719;2.344466;-6;555;7069;19.1;1350;14656
318;15;1996;111;253;139;1291;13834;5932;2.332097;-28;497;7280;18.52;1348;15125
319;15;1997;132;166;162;1331;14075;6102;2.306621;-30;311;7533;19;1431;15406
320;15;1998;143;197;144;1351;14175;6147;2.306003;-1;121;7699;20.16;1552;15526
321;15;1999;138;218;126;1371;14565;6350;2.293701;12;398;7914;19.76;1564;15936
322;15;2000;137;56;134;1363;14949;6623;2.257134229;3;374;8449;21.61;1826;16312
323;15;2001;157;224;146;1337;15073;6707;2.247353511;11;87;8660;22.55;1953;16410
324;15;2002;139;213;162;1333;15313;6844;2.237434249;-23;259;8840;22.58;1996;16646
325;15;2003;137;241;137;1360;15434;6928;2.227771363;0;148;9060;23.53;2132;16794
326;15;2004;147;196;147;1332;15614;7041;2.21758273;0;152;9243;23.82;2202;16946
327;15;2005;151;164;140;1338;15684;7109;2.206217471;11;65;9419;24.52;2310;17022
328;15;2006;142;151;162;1336;15648;7127;2.195594219;-20;-18;9549;25.36;2422;16984
329;15;2007;132;154;153;1408;15830;7247;2.184352146;-21;275;9725;25.48;2478;17238
330;15;2008;130;209;169;1337;16066;7391;2.1737248;-39;204;9943;25.67;2552;17403
331;15;2009;156;130;143;1366;16238;7507;2.163047822;13;188;9988;24.84;2481;17604
332;15;2010;138;22.75;157;1436;16361;7596;2.153896788;-19;212;10043;24.37;2447;17797
333;15;2011;147;86.85;157;1492;16537;7675;2.15465798;-10;242;10132;24.25;2457;18029
334;15;2012;152;69;157;1489;16674;7739;2.15454193;-5;139;10207;24.18;2468;18163
335;15;2013;110;107.16;179;1345;16985;7884;2.154363267;-69;236;10312;23.55;2428;18330
336;15;2014;143;116.02;168;1491;16972;7879;2.154080467;-25;158;10419;24.38;2540;18463
337;15;2015;138;147;203;1443;17149;7961;2.154126366;-65;194;10562;24.63;2601;18592
338;15;2016;134;255;184;1501;17594;8176;2.151908023;-50;553;10827;24.49;2651;19095
339;15;2017;130;221.37;177;1488;18144;8424;2.153846154;-47;584;11043;23.72;2619;19632
340;15;2018;144;154;173;1499;18525;8598;2.15457083;-29;421;11188;23.15;2590;20024
341;17;1985;55;3;21;14;2280;965;2.362694;34;23;1060;8.96;95;2294
342;17;1986;35;2;24;13;2172;937;2.318036;11;-120;1090;14.04;153;2185
343;17;1987;37;1;27;13;2084;919;2.267682;10;-98;1119;17.87;200;2097
344;17;1988;48;5;26;14;2194;985;2.227411;22;89;1122;12.21;137;2208
345;17;1989;46;2;35;15;2299;1021;2.251714;11;95;1128;9.49;107;2314
346;17;1990;26;4;22;45;2368;904;2.619469;4;95;1083;16.53;179;2413
347;17;1991;40;2;24;40;2436;818;2.977995;16;47;1087;24.75;269;2476
348;17;1992;41;3;22;45;2362;910;2.595604;19;-88;1089;16.44;179;2407
349;17;1993;36;5;21;44;2262;886;2.553047;15;-116;1092;18.86;206;2306
350;17;1994;20;4;21;44;2247;885;2.538983;-1;-14;1097;19.33;212;2291
351;17;1995;29;2;17;44;2225;880;2.528409;12;-34;1101;20.07;221;2269
352;17;1996;33;2;21;45;2239;893;2.507279;12;3;1103;19.04;210;2284
353;17;1997;19;6;26;46;2249;910;2.471429;-7;18;1105;17.65;195;2295
354;17;1998;30;2;26;46;2297;935;2.456685;4;44;1111;15.84;176;2343
355;17;1999;32;3;23;46;2233;916;2.437773;9;-73;1113;17.7;197;2279
356;17;2000;23;1;15;30;2186;876;2.49543379;8;-68;1103;20.58;227;2216
357;17;2001;17;3;15;30;2143;865;2.477456647;2;-45;1090;20.64;225;2173
358;17;2002;28;4;20;30;2132;869;2.453394707;8;-19;1078;19.39;209;2162
359;17;2003;21;0;32;30;2089;861;2.426248548;-11;-32;1064;19.08;203;2119
360;17;2004;17;1;28;30;2040;847;2.40850059;-11;-38;1050;19.33;203;2070
361;17;2005;22;3;27;30;2011;844;2.382701422;-5;-24;1038;18.69;194;2041
362;17;2006;21;3;21;30;1947;823;2.365735115;0;-64;1026;19.79;203;1977
363;17;2007;26;1;14;30;1880;801;2.347066167;12;-79;1013;20.93;212;1910
364;17;2008;24;0;19;30;1868;804;2.323383085;5;-17;999;19.52;195;1898
365;17;2009;22;0;34;30;1803;785;2.296815287;-12;-53;985;20.3;200;1833
366;17;2010;21;0;18;42;1792;786;2.279898219;3;-2;975;19.38;189;1834
367;17;2011;21;1;21;42;1821;798;2.281954887;0;29;976;18.24;178;1863
368;17;2012;38;0;27;42;1831;802;2.283042394;11;-1;976;17.83;174;1873
369;17;2013;27;4;18;42;1837;804;2.284825871;9;-3;985;18.38;181;1879
370;17;2014;27;1;15;42;1805;791;2.281921618;12;-44;986;19.78;195;1847
371;17;2015;29;7;19;42;1788;783;2.283524904;10;-27;993;21.15;210;1830
372;17;2016;26;9;21;42;1811;792;2.286616162;5;18;1001;20.88;209;1853
373;17;2017;21;3;20;42;1816;795;2.28427673;1;4;1005;20.9;210;1858
374;17;2018;15;3;22;42;1819;796;2.285175879;-7;10;1008;21.03;212;1861
375;19;1985;140;53;40;45;7891;3093;2.551245;100;84;4596;32.7;1503;7936
376;19;1986;123;35;37;46;8113;3184;2.548053;86;137;4647;31.48;1463;8159
377;19;1987;131;39;26;44;7778;3055;2.54599;105;-442;4681;34.74;1626;7822
378;19;1988;112;18;33;43;7684;3024;2.541005;79;-174;4724;35.99;1700;7727
379;19;1989;115;18;35;42;7625;3006;2.536593;80;-140;4839;37.88;1833;7667
380;19;1990;105;23;34;45;7568;3153;2.400254;71;-125;4811;34.46;1658;7613
381;19;1991;108;22;32;41;7612;2972;2.561238;76;-36;4834;38.52;1862;7653
382;19;1992;114;65;34;44;7798;3132;2.489783;80;109;4856;35.5;1724;7842
383;19;1993;114;69;37;47;7990;3324;2.40373;77;118;4921;32.45;1597;8037
384;19;1994;118;81;44;50;8408;3485;2.412626;74;347;4990;30.16;1505;8458
385;19;1995;117;83;54;50;8634;3579;2.412406;63;163;5071;29.42;1492;8684
386;19;1996;122;93;50;50;8666;3606;2.403217;72;-40;5154;30.03;1548;8716
387;19;1997;103;83;36;51;8829;3700;2.386216;67;97;5247;29.48;1547;8880
388;19;1998;101;102;36;51;8947;3750;2.385867;65;53;5330;29.64;1580;8998
389;19;1999;116;88;42;51;9132;3827;2.386203;74;111;5432;29.55;1605;9183
390;19;2000;110;14;39;42;9319;4050;2.300987654;71;104;5175;21.74;1125;9361
391;19;2001;118;56;38;42;9422;4122;2.2857836;80;23;5245;21.41;1123;9464
392;19;2002;108;63;50;42;9424;4151;2.270296314;58;-56;5313;21.87;1162;9466
393;19;2003;92;71;48;42;9475;4200;2.255952381;44;7;5382;21.96;1182;9517
394;19;2004;102;56;44;42;9419;4203;2.24101832;58;-114;5461;23.04;1258;9461
395;19;2005;99;41;60;42;9350;4203;2.224601475;39;-108;5511;23.73;1308;9392
396;19;2006;121;34;42;42;9237;4179;2.210337401;79;-192;5545;24.63;1366;9279
397;19;2007;82;33;57;42;9291;4233;2.194897236;25;29;5596;24.36;1363;9333
398;19;2008;99;22;43;42;9252;4243;2.180532642;56;-95;5638;24.74;1395;9294
399;19;2009;76;15;43;42;9018;4165;2.165186074;33;-267;5664;26.47;1499;9060
400;19;2010;81;2;64;131;9024;4217;2.139909889;17;78;5687;25.85;1470;9155
401;19;2011;69;13;58;104;8951;4183;2.139851781;11;-111;5700;26.61;1517;9055
402;19;2012;63;16;46;121;8949;4182;2.139885222;17;-2;5716;26.84;1534;9070
403;19;2013;70;6.31;59;90;8955;4184;2.140296367;11;-36;5711;26.74;1527;9045
404;19;2014;80;44.56;62;85;9056;4231;2.140392342;18;78;5750;26.42;1519;9141
405;19;2015;62;11.56;60;111;9182;4289;2.140825367;2;150;5759;25.53;1470;9293
406;19;2016;74;19.77;60;113;9293;4341;2.140750979;14;99;5775;24.83;1434;9406
407;19;2017;76;12;53;115;9515;4445;2.140607424;23;201;5787;23.19;1342;9630
408;19;2018;80;30;69;125;9538;4456;2.14048474;11;22;5817;23.4;1361;9663
409;21;1985;143;1;60;0;7776;2486;3.127916;83;-312;3316;25.03;830;7776
410;21;1986;137;0;79;0;7947;2576;3.085016;58;113;3313;22.25;737;7947
411;21;1987;137;4;71;0;8090;2649;3.053983;66;77;3310;19.97;661;8090
412;21;1988;133;1;49;0;7854;2599;3.021931;84;-320;3318;21.67;719;7854
413;21;1989;137;0;63;0;7623;2553;2.985899;74;-305;3309;22.85;756;7623
414;21;1990;128;1;54;30;7421;2492;2.977929;74;-246;3574;30.27;1082;7451
415;21;1991;111;0;54;28;7506;2378;3.156434;57;26;3575;33.48;1197;7534
416;21;1992;113;1;82;29;7485;2443;3.063856;31;-51;3575;31.66;1132;7514
417;21;1993;127;0;63;30;7612;2518;3.023034;64;64;3576;29.59;1058;7642
418;21;1994;116;4;71;31;7724;2543;3.037358;45;68;3581;28.99;1038;7755
419;21;1995;116;1;76;31;7875;2582;3.049961;40;111;3585;27.98;1003;7906
420;21;1996;132;168;70;31;7988;2615;3.054684;62;51;3586;27.08;971;8019
421;21;1997;128;166;66;32;8068;2651;3.04338;62;19;3754;29.38;1103;8100
422;21;1998;134;175;84;32;8155;2670;3.054307;50;37;3920;31.89;1250;8187
423;21;1999;121;181;72;32;8276;2698;3.067457;49;72;3888;30.61;1190;8308
424;21;2000;142;0;85;53;8355;2989;2.795249247;57;38;3887;23.1;898;8408
425;21;2001;133;0;72;53;8312;2990;2.77993311;61;-104;3886;23.06;896;8365
426;21;2002;105;0;74;53;8336;3015;2.764842454;31;-7;3887;22.43;872;8389
427;21;2003;109;198;75;53;8334;3032;2.748680739;34;-36;4084;25.76;1052;8387
428;21;2004;122;29;75;53;8448;3093;2.731328807;47;67;4112;24.78;1019;8501
429;21;2005;123;46;72;53;8447;3111;2.715204114;51;-52;4157;25.16;1046;8500
430;21;2006;116;36;64;53;8417;3120;2.69775641;52;-82;4193;25.59;1073;8470
431;21;2007;127;37;74;53;8380;3123;2.683317323;53;-90;4228;26.14;1105;8433
432;21;2008;123;28;77;53;8331;3123;2.667627281;46;-95;4257;26.64;1134;8384
433;21;2009;113;14;79;53;8157;3079;2.649236765;34;-208;4274;27.96;1195;8210
434;21;2010;137;4.25;73;36;8246;3128;2.636189258;64;8;4289;27.07;1161;8282
435;21;2011;104;17;88;36;8222;3117;2.637792749;16;-40;4307;27.63;1190;8258
436;21;2012;126;13;82;36;8184;3104;2.636597938;44;-82;4321;28.16;1217;8220
437;21;2013;109;13;99;36;8139;3087;2.63654033;10;-55;4335;28.79;1248;8175
438;21;2014;122;15;71;36;8169;3097;2.637713917;51;-21;4350;28.8;1253;8205
439;21;2015;116;13;93;36;8006;3036;2.637022398;23;-186;4364;30.43;1328;8042
440;21;2016;96;21;88;36;7989;3029;2.637504127;8;-25;4385;30.92;1356;8025
441;21;2017;95;20;71;36;8085;3065;2.637846656;24;72;4405;30.42;1340;8121
442;21;2018;82;24;92;36;8102;3071;2.63822859;-10;27;4429;30.66;1358;8138
443;23;1985;50;0;20;0;3363;1167;2.881748;30;73;1614;27.7;447;3363
444;23;1986;39;0;36;0;3307;1158;2.855786;3;-59;1640;29.39;482;3307
445;23;1987;57;0;24;0;3349;1181;2.835732;33;9;1667;29.15;486;3349
446;23;1988;43;0;23;0;3397;1207;2.814416;20;28;1671;27.77;464;3397
447;23;1989;54;0;21;0;3277;1175;2.788936;33;-153;1600;26.56;425;3277
448;23;1990;40;0;29;2;3191;1192;2.677013;11;-95;1743;31.61;551;3193
449;23;1991;40;0;23;0;3256;1137;2.863676;17;46;1743;34.77;606;3256
450;23;1992;45;0;24;2;3188;1196;2.665552;21;-87;1743;31.38;547;3190
451;23;1993;44;0;38;2;3335;1223;2.726901;6;141;2133;42.66;910;3337
452;23;1994;50;0;33;2;3374;1224;2.756536;17;22;2133;42.62;909;3376
453;23;1995;58;0;36;2;3509;1265;2.773913;22;113;2133;40.69;868;3511
454;23;1996;42;0;39;2;3579;1290;2.774419;3;67;2133;39.52;843;3581
455;23;1997;47;0;46;2;3639;1314;2.769406;1;59;2133;38.4;819;3641
456;23;1998;40;0;37;2;3698;1329;2.782543;3;56;2133;37.69;804;3700
457;23;1999;50;0;36;2;3677;1314;2.798326;14;-35;2133;38.4;819;3679
458;23;2000;40;0;37;0;3674;1511;2.431502316;3;-9;2211;31.66;700;3674
459;23;2001;47;0;38;0;3741;1547;2.41822883;9;58;2244;31.06;697;3741
460;23;2002;47;0;33;0;3734;1557;2.39820167;14;-21;2278;31.65;721;3734
461;23;2003;48;0;46;0;3800;1594;2.383939774;2;64;2300;30.7;706;3800
462;23;2004;29;0;51;0;3802;1605;2.368847352;-22;24;2330;31.12;725;3802
463;23;2005;39;25;34;0;3695;1570;2.353503185;5;-112;2373;33.84;803;3695
464;23;2006;39;23;39;0;3698;1583;2.336070752;0;3;2426;34.75;843;3698
465;23;2007;29;19;32;0;3676;1585;2.319242902;-3;-19;2473;35.91;888;3676
466;23;2008;31;17;38;0;3611;1569;2.301465902;-7;-58;2523;37.81;954;3611
467;23;2009;33;12;29;0;3505;1533;2.286366601;4;-110;2584;40.67;1051;3505
468;23;2010;27;8.5;28;0;3532;1554;2.272844273;-1;28;2651;41.38;1097;3532
469;23;2011;37;54.03;32;0;3647;1605;2.272274143;5;110;2711;40.8;1106;3647
470;23;2012;29;22;41;0;3608;1587;2.27347196;-12;-27;2715;41.55;1128;3608
471;23;2013;29;22.79;43;0;3548;1561;2.272901986;-14;-46;2720;42.61;1159;3548
472;23;2014;28;27;42;0;3573;1572;2.272900763;-14;39;2720;42.21;1148;3573
473;23;2015;29;30;34;0;3585;1577;2.273303741;-5;17;2720;42.02;1143;3585
474;23;2016;30;35;47;0;3705;1630;2.273006135;-17;137;2720;40.07;1090;3705
475;23;2017;40;44;36;0;3771;1658;2.274427021;4;62;2721;39.07;1063;3771
476;23;2018;31;0;43;0;3810;1676;2.27326969;-12;51;2721;38.4;1045;3810
477;25;1985;51;1;36;53;2944;1262;2.332805;15;94;1309;3.59;47;2997
478;25;1986;51;3;42;53;2932;1288;2.276397;9;-21;1310;1.68;22;2985
479;25;1987;42;42;33;56;3016;1341;2.249068;9;78;1362;1.54;21;3072
480;25;1988;41;1;31;945;2897;1340;2.16194;10;760;1405;4.63;65;3842
481;25;1989;32;1;48;1070;2831;1322;2.141452;-16;75;1405;5.91;83;3901
482;25;1990;49;1;27;1031;2898;1165;2.487554;22;6;1415;17.67;250;3929
483;25;1991;50;1;26;1052;2921;1175;2.485957;24;20;1416;17.02;241;3973
484;25;1992;46;0;38;1089;3051;1224;2.492647;8;159;1417;13.62;193;4140
485;25;1993;40;0;46;1081;3064;1223;2.505315;-6;11;1417;13.69;194;4145
486;25;1994;29;1;56;1135;3072;1240;2.477419;-27;89;1417;12.49;177;4207
487;25;1995;51;1;37;1078;3143;1289;2.438324;14;0;1418;9.1;129;4221
488;25;1996;48;2;49;1140;3126;1324;2.361027;-1;46;1419;6.69;95;4266
489;25;1997;44;2;37;1184;3119;1338;2.331091;7;30;1442;7.21;104;4303
490;25;1998;52;2;51;1177;3109;1350;2.302963;1;-18;1444;6.51;94;4286
491;25;1999;48;4;38;1920;3078;1467;2.09816;10;702;1539;4.68;72;4998
492;25;2000;45;5;34;1590;3540;1369;2.585829072;11;117;1546;11.45;177;5130
493;25;2001;41;19;39;1842;3411;1327;2.570459683;2;121;1561;14.99;234;5253
494;25;2002;42;3;49;1975;3369;1319;2.554207733;-7;98;1561;15.5;242;5344
495;25;2003;43;2;49;1850;3306;1305;2.533333333;-6;-182;1560;16.35;255;5156
496;25;2004;53;1;55;2125;3307;1316;2.512917933;-2;278;1558;15.53;242;5432
497;25;2005;40;4;48;2240;3197;1281;2.495706479;-8;13;1560;17.88;279;5437
498;25;2006;35;5;47;2580;3133;1264;2.478639241;-12;288;1561;19.03;297;5713
499;25;2007;28;0;45;2865;3042;1238;2.457189015;-17;211;1559;20.59;321;5907
500;25;2008;31;8;40;2925;2968;1217;2.438783895;-9;-5;1562;22.09;345;5893
501;25;2009;44;0;47;2938;2865;1184;2.419763514;-3;-87;1561;24.15;377;5803
502;25;2010;37;0.25;32;2682;3156;1311;2.407322654;5;30;1559;15.91;248;5838
503;25;2011;34;4;36;2638;3210;1334;2.406296852;-2;12;1563;14.65;229;5848
504;25;2012;40;2;47;2291;3138;1306;2.402756508;-7;-412;1565;16.55;259;5429
505;25;2013;41;0;39;2242;3069;1276;2.405172414;2;-120;1565;18.47;289;5311
506;25;2014;31;3;42;2516;3065;1275;2.403921569;-11;281;1568;18.69;293;5581
507;25;2015;42;7;37;2580;3009;1250;2.4072;5;3;1575;20.63;325;5589
508;25;2016;27;5;56;2208;3017;1254;2.405901116;-29;-335;1580;20.63;326;5225
509;25;2017;29;4;48;2823;2954;1227;2.407497963;-19;571;1584;22.54;357;5777
510;25;2018;29;3;37;2827;3028;1259;2.4050834;-8;86;1587;20.67;328;5855
511;27;1985;22;0;22;18;2048;823;2.488457;0;160;1300;36.69;477;2066
512;27;1986;26;1;18;18;2057;839;2.451728;8;1;1304;35.66;465;2075
513;27;1987;25;1;6;18;2032;839;2.421931;19;-44;1310;35.95;471;2050
514;27;1988;17;14;12;17;1959;821;2.386115;5;-79;1313;37.47;492;1976
515;27;1989;24;0;15;17;1930;821;2.350792;9;-38;1336;38.55;515;1947
516;27;1990;13;0;6;1;1943;770;2.523377;7;-10;2216;65.25;1446;1944
517;27;1991;13;37;12;1;2011;832;2.417067;1;67;2216;62.45;1384;2012
518;27;1992;28;44;19;1;2140;941;2.274176;9;120;2253;58.23;1312;2141
519;27;1993;19;66;22;1;2322;945;2.457143;-3;185;2297;58.86;1352;2323
520;27;1994;36;87;14;1;2417;986;2.451319;22;73;2363;58.27;1377;2418
521;27;1995;34;92;12;1;2617;1075;2.434419;22;178;2450;56.12;1375;2618
522;27;1996;35;81;24;1;2847;1182;2.408629;11;219;2542;53.5;1360;2848
523;27;1997;30;218;13;1;3056;1286;2.376361;17;192;2623;50.97;1337;3057
524;27;1998;35;137;14;1;3174;1343;2.363366;21;97;2841;52.73;1498;3175
525;27;1999;34;90;21;1;3363;1434;2.345188;13;176;2978;51.85;1544;3364
526;27;2000;35;35;21;16;3504;1491;2.350100604;14;149;3029;50.78;1538;3520
527;27;2001;30;139;15;16;3714;1595;2.328526646;15;195;3079;48.2;1484;3730
528;27;2002;31;115;27;16;3767;1633;2.306797306;4;49;3157;48.27;1524;3783
529;27;2003;25;162;28;16;3918;1715;2.284548105;-3;154;3249;47.21;1534;3934
530;27;2004;36;126;21;16;3968;1755;2.260968661;15;35;3313;47.03;1558;3984
531;27;2005;24;106;30;16;4029;1800;2.238333333;-6;67;3442;47.7;1642;4045
532;27;2006;15;100;33;16;4001;1806;2.215393134;-18;-10;3573;49.45;1767;4017
533;27;2007;23;85;26;16;4114;1873;2.196476241;-3;116;3696;49.32;1823;4130
534;27;2008;26;69;26;16;4103;1888;2.173199153;0;-11;3797;50.28;1909;4119
535;27;2009;24;51;39;16;4150;1931;2.14914552;-15;62;3888;50.33;1957;4166
536;27;2010;25;15;37;15;4257;1997;2.131697546;-12;118;3973;49.74;1976;4272
537;27;2011;22;67;29;15;4203;1971;2.132420091;-7;-47;4036;51.16;2065;4218
538;27;2012;26;66;36;15;4197;1967;2.133706151;-10;4;4102;52.05;2135;4212
539;27;2013;21;54;36;15;4241;1988;2.133299799;-15;59;4155;52.15;2167;4256
540;27;2014;22;47;34;15;4321;2025;2.13382716;-12;92;4201;51.8;2176;4336
541;27;2015;26;43;35;15;4415;2069;2.133881102;-9;103;4243;51.24;2174;4430
542;27;2016;18;43;53;15;4563;2139;2.133239832;-35;183;4285;50.08;2146;4578
543;27;2017;37;57;44;15;4843;2269;2.13442045;-7;287;4344;47.77;2075;4858
544;27;2018;32;74;48;15;4914;2304;2.1328125;-16;87;4416;47.83;2112;4929
545;29;1985;323;10;245;331;23135;9237;2.504601;78;-617;9974;7.39;737;23466
546;29;1986;290;-6;222;316;22037;8903;2.475233;68;-1181;9689;8.11;786;22353
547;29;1987;259;3;266;309;21473;8770;2.448461;-7;-564;9387;6.57;617;21782
548;29;1988;236;-3;248;351;21151;8735;2.421408;-12;-268;9402;7.09;667;21502
549;29;1989;241;-1;265;366;20839;8718;2.390342;-24;-273;9397;7.23;679;21205
550;29;1990;227;3;271;500;20491;8372;2.447563;-44;-170;10082;16.96;1710;20991
551;29;1991;236;4;264;652;20577;8635;2.382976;-28;266;10085;14.38;1450;21229
552;29;1992;280;40;270;688;21181;9070;2.335281;10;630;10089;10.1;1019;21869
553;29;1993;268;39;257;555;22678;9248;2.452206;11;1353;10159;8.97;911;23233
554;29;1994;274;54;284;716;23627;9580;2.466284;-10;1120;10453;8.35;873;24343
555;29;1995;306;47;292;719;24474;9902;2.471622;14;836;10507;5.76;605;25193
556;29;1996;300;59;319;877;24841;10050;2.471741;-19;544;10557;4.8;507;25718
557;29;1997;298;39;311;1121;24884;10143;2.453318;-13;300;10616;4.46;473;26005
558;29;1998;309;75;296;1208;25613;10296;2.487665;13;803;10655;3.37;359;26821
559;29;1999;299;94;317;1295;26105;10413;2.506963;-18;597;10730;2.95;317;27400
560;29;2000;296;23;330;916;26993;11098;2.432240043;-34;535;12410;10.57;1312;27909
561;29;2001;316;91;314;929;27458;11312;2.427333805;2;476;12685;10.82;1373;28387
562;29;2002;317;27;339;923;27855;11500;2.422173913;-22;413;12926;11.03;1426;28778
563;29;2003;344;41;329;890;28171;11657;2.416659518;15;268;13175;11.52;1518;29061
564;29;2004;330;73;299;923;28530;11833;2.411053833;31;361;13453;12.04;1620;29453
565;29;2005;336;92;336;934;28478;11838;2.405642845;0;-41;13733;13.8;1895;29412
566;29;2006;346;113;303;935;28767;11984;2.400450601;43;247;14040;14.64;2056;29702
567;29;2007;353;143;323;909;28968;12095;2.395039272;30;145;14265;15.21;2170;29877
568;29;2008;369;110;351;914;29428;12310;2.390576767;18;447;14439;14.74;2129;30342
569;29;2009;329;91;358;935;29690;12451;2.384547426;-29;312;14516;14.23;2065;30625
570;29;2010;341;3.25;339;713;30176;12679;2.379998423;2;262;14575;13.01;1896;30889
571;29;2011;344;14;356;680;29729;12488;2.380605381;-12;-468;14586;14.38;2098;30409
572;29;2012;337;57;316;723;29786;12512;2.380594629;21;79;14634;14.5;2122;30509
573;29;2013;320;18;317;545;29818;12525;2.380678643;3;-149;14643;14.46;2118;30363
574;29;2014;292;17;362;683;29303;12308;2.38080923;-70;-307;14659;16.04;2351;29986
575;29;2015;271;64;379;692;29254;12286;2.381084161;-108;68;14718;16.52;2432;29946
576;29;2016;281;7;358;708;29679;12467;2.380604797;-77;518;14712;15.26;2245;30387
577;29;2017;281;15;382;733;29862;12543;2.380770151;-101;309;14723;14.81;2180;30595
578;29;2018;280;46;438;723;30212;12692;2.380397101;-158;498;14766;14.05;2074;30935
579;31;1985;8952;1272;4541;13031;483400;226540;2.13384;4411;-4595;238346;4.95;11806;496431
580;31;1986;9183;2417;4624;13117;483897;230128;2.10273;4559;-3976;239660;3.98;9532;497014
581;31;1987;8856;1109;4509;13044;477230;229863;2.07615;4347;-11087;242120;5.06;12257;490274
582;31;1988;8375;434;4458;13081;466541;227410;2.051541;3917;-14569;243234;6.51;15824;479622
583;31;1989;8252;512;4415;12812;459973;227897;2.018337;3837;-10674;243525;6.42;15628;472785
584;31;1990;8633;-58;4389;10850;457004;210952;2.166389;4244;-9175;239636;11.97;28684;467854
585;31;1991;8548;-104;4450;11489;463694;216613;2.140656;4098;3231;239578;9.59;22965;475183
586;31;1992;8807;283;4565;11751;476507;222322;2.143319;4242;8833;239474;7.16;17152;488258
587;31;1993;8611;785;4670;12158;489177;221386;2.209611;3941;9136;239757;7.66;18371;501335
588;31;1994;8401;1661;4711;11631;492618;221418;2.224833;3690;-776;240542;7.95;19124;504249
589;31;1995;8062;786;4886;11792;495931;222532;2.228583;3176;298;242644;8.29;20112;507723
590;31;1996;8349;1432;4731;11005;507250;225615;2.248299;3618;6914;243430;7.32;17815;518255
591;31;1997;8594;2261;4684;10214;517228;229556;2.253167;3910;5277;244862;6.25;15306;527442
592;31;1998;8608;4689;4648;10096;523310;231418;2.261319;3960;2004;247123;6.36;15705;533406
593;31;1999;9183;3379;4483;13382;532135;240788;2.209973;4700;7411;252354;4.58;11566;545517
594;31;2000;9544;887;4390;12719;544019;240360;2.263350807;5154;6069;252392;4.77;12032;556738
595;31;2001;10297;3546;4310;12922;550378;243645;2.258934105;5987;575;256223;4.91;12578;563300
596;31;2002;10278;4338;4444;12986;546104;242226;2.254522636;5834;-10044;260857;7.14;18631;559090
597;31;2003;10404;4491;4234;13123;547225;243200;2.250102796;6170;-4912;265654;8.45;22454;560348
598;31;2004;10269;2958;4318;13353;546877;243523;2.245689319;5951;-6069;268921;9.44;25398;560230
599;31;2005;10436;3993;4278;13355;546104;243658;2.241272603;6158;-6929;273126;10.79;29468;559459
600;31;2006;10134;3047;4194;13367;549495;245655;2.236856567;5940;-2537;276569;11.18;30914;562862
601;31;2007;10084;3655;4134;13245;557192;249588;2.232447073;5950;1625;280158;10.91;30570;570437
602;31;2008;10169;3494;4183;13223;568680;255239;2.228029416;5986;5480;281076;9.19;25837;581903
603;31;2009;10184;3053;4134;13308;582265;261855;2.223616123;6050;7620;283636;7.68;21781;595573
604;31;2010;9716;222;4229;15981;588898;265233;2.220304412;5487;3819;287392;7.71;22159;604879
605;31;2011;9634;1263;4184;16220;605831;272860;2.220299787;5450;11722;288510;5.42;15650;622051
606;31;2012;9189;2236;4170;16214;620465;279451;2.220299802;5019;9609;290586;3.83;11135;636679
607;31;2013;9261;5382;4216;16123;634858;285933;2.220303358;5045;9257;295485;3.23;9552;650981
608;31;2014;9327;6219;4233;16218;650019;292761;2.220305983;5094;10162;301378;2.86;8617;666237
609;31;2015;9365;6117;4323;16517;668540;301103;2.220303351;5042;13778;307093;1.95;5990;685057
610;31;2016;9417;8714;4467;16474;681532;306955;2.220299392;4950;7999;315145;2.6;8190;698006
611;31;2017;9009;7660;4370;16621;690293;310900;2.220305564;4639;4269;321983;3.44;11083;706914
612;31;2018;8943;10525;4434;16614;701182;315805;2.220300502;4509;6373;332400;4.99;16595;717796
613;33;1985;27;0;9;0;1548;571;2.711033;18;-154;916;37.66;345;1548
614;33;1986;20;0;11;0;1529;571;2.677758;9;-28;945;39.58;374;1529
615;33;1987;29;0;13;0;1494;562;2.658363;16;-51;974;42.3;412;1494
616;33;1988;24;0;11;0;1591;604;2.634106;13;84;976;38.11;372;1591
617;33;1989;18;0;17;0;1541;591;2.607445;1;-51;1009;41.43;418;1541
618;33;1990;17;0;10;0;1489;581;2.562823;7;-59;947;38.65;366;1489
619;33;1991;16;6;13;0;1437;537;2.675978;3;-55;947;43.29;410;1437
620;33;1992;18;4;13;0;1403;502;2.794821;5;-39;953;47.32;451;1403
621;33;1993;16;8;13;0;1426;559;2.550984;3;20;957;41.59;398;1426
622;33;1994;13;5;8;0;1499;588;2.54932;5;68;970;39.38;382;1499
623;33;1995;18;12;21;0;1566;617;2.538088;-3;70;975;36.72;358;1566
624;33;1996;23;6;14;0;1636;649;2.520801;9;61;987;34.25;338;1636
625;33;1997;24;3;16;0;1674;673;2.48737;8;30;993;32.23;320;1674
626;33;1998;13;6;9;0;1766;713;2.476858;4;88;996;28.41;283;1766
627;33;1999;16;6;22;0;1811;735;2.463946;-6;51;1002;26.65;267;1811
628;33;2000;21;2;18;0;1849;788;2.346446701;3;36;1200;34.33;412;1849
629;33;2001;22;7;19;0;1865;796;2.342964824;3;13;1226;35.07;430;1865
630;33;2002;22;8;21;0;1880;805;2.335403727;1;14;1254;35.81;449;1880
631;33;2003;20;9;24;0;1879;807;2.328376704;-4;3;1283;37.1;476;1879
632;33;2004;23;7;19;0;1873;805;2.326708075;4;-10;1312;38.64;507;1873
633;33;2005;21;6;11;0;1888;814;2.319410319;10;5;1338;39.16;524;1888
634;33;2006;22;6;20;0;1990;860;2.313953488;2;100;1367;37.09;507;1990
635;33;2007;27;5;20;0;2001;867;2.307958478;7;4;1394;37.8;527;2001
636;33;2008;30;3;19;0;2074;900;2.304444444;11;62;1422;36.71;522;2074
637;33;2009;28;1;16;0;2052;892;2.30044843;12;-34;1448;38.4;556;2052
638;33;2010;17;0.25;14;0;2060;898;2.293986637;3;5;1468;38.83;570;2060
639;33;2011;18;0;17;0;2036;887;2.295377678;1;-25;1468;39.58;581;2036
640;33;2012;24;0;17;0;2002;872;2.29587156;7;-41;1468;40.6;596;2002
641;33;2013;17;1;18;0;2026;882;2.297052154;-1;25;1469;39.96;587;2026
642;33;2014;15;0;30;0;1968;857;2.29638273;-15;-43;1469;41.66;612;1968
643;33;2015;19;9;12;0;1974;860;2.295348837;7;-1;1478;41.81;618;1974
644;33;2016;15;0;14;0;2050;893;2.295632699;1;75;1478;39.58;585;2050
645;33;2017;12;0;21;0;2039;889;2.293588301;-9;-2;1478;39.85;589;2039
646;33;2018;16;0;21;0;2054;895;2.294972067;-5;20;1478;39.45;583;2054
647;35;1985;679;2160;129;163;39885;11824;3.373224;550;3214;15225;22.34;3401;40048
648;35;1986;772;2370;122;169;45485;13530;3.361789;650;4956;17810;24.03;4280;45654
649;35;1987;853;1825;133;178;48666;14345;3.392541;720;2470;20189;28.95;5844;48844
650;35;1988;991;1604;171;191;52936;15439;3.42872;820;3463;22017;29.88;6578;53127
651;35;1989;1129;1475;162;201;56963;16649;3.421407;967;3070;23622;29.52;6973;57164
652;35;1990;1208;1587;144;217;61342;20844;2.942909;1064;3331;22291;6.49;1447;61559
653;35;1991;1311;1916;159;239;66449;23010;2.887831;1152;3977;23878;3.64;868;66688
654;35;1992;1369;2946;190;271;75090;25714;2.920199;1179;7494;25794;0.31;80;75361
655;35;1993;1483;3295;222;295;82837;28231;2.934257;1261;6510;28810;2.01;579;83132
656;35;1994;1617;4045;262;332;92194;31588;2.91864;1355;8039;32229;1.99;641;92526
657;35;1995;1719;4785;239;364;103475;35498;2.914953;1480;9833;36274;2.14;776;103839
658;35;1996;1981;5732;251;395;114318;39371;2.903609;1730;9144;41059;4.11;1688;114713
659;35;1997;2281;5564;329;442;128889;44778;2.8784;1952;12666;46739;4.2;1961;129331
660;35;1998;2525;6443;350;442;143912;49767;2.891715;2175;12848;52303;4.85;2536;144354
661;35;1999;2897;7166;399;442;161881;55522;2.915619;2498;15471;58385;4.9;2863;162323
662;35;2000;3281;1557;438;654;179856;62610;2.872640153;2843;15343;65623;4.59;3013;180510
663;35;2001;3648;6227;490;654;198384;69278;2.86359306;3158;15370;72898;4.97;3620;199038
664;35;2002;3765;5914;505;654;209051;73226;2.854873952;3260;7407;79062;7.38;5836;209705
665;35;2003;3999;4397;534;661;220485;77472;2.845995973;3465;7976;84225;8.02;6753;221146
666;35;2004;3967;3616;585;581;233065;82144;2.837273568;3382;9118;88496;7.18;6352;233646
667;35;2005;4159;4987;589;703;243739;86168;2.828648686;3570;7226;93034;7.38;6866;244442
668;35;2006;4112;5378;654;720;257113;91172;2.820087308;3458;9933;98058;7.02;6886;257833
669;35;2007;4205;3786;748;728;267871;95275;2.811556022;3457;7309;101912;6.51;6637;268599
670;35;2008;3938;2168;784;967;275773;98378;2.803197869;3154;4987;104350;5.72;5972;276740
671;35;2009;3773;1344;779;1042;281121;100581;2.794971217;2994;2429;106155;5.25;5574;282163
672;35;2010;3627;212.85;904;800;286324;102559;2.791797892;2723;2238;107064;4.21;4505;287124
673;35;2011;3557;1539.25;905;772;291878;104552;2.791701737;2652;2874;108488;3.63;3936;292650
674;35;2012;3477;1318.94;1034;775;298061;106769;2.791643642;2443;3743;109770;2.73;3001;298836
675;35;2013;3429;2483.01;1043;871;305613;109510;2.79073144;2386;5262;112213;2.41;2703;306484
676;35;2014;3536;2594;1035;871;313951;112485;2.791047695;2501;5837;114734;1.96;2249;314822
677;35;2015;3376;3204.73;1252;871;321353;115143;2.790903485;2124;5278;118081;2.49;2938;322224
678;35;2016;3495;3158.61;1338;871;327499;117311;2.791716037;2157;3989;119555;1.88;2244;328370
679;35;2017;3507;3601.47;1337;871;335030;119997;2.791986466;2170;5361;123011;2.45;3014;335901
680;35;2018;3417;3742.78;1434;871;341976;122468;2.792370252;1983;4963;128829;4.94;6361;342847
681;37;1985;386;74;41;6;18023;7498;2.403708;345;923;13585;44.81;6087;18029
682;37;1986;361;203;56;7;18846;7820;2.409974;305;519;13921;43.83;6101;18853
683;37;1987;370;205;61;7;18995;8050;2.359627;309;-160;14093;42.88;6043;19002
684;37;1988;370;392;53;7;19560;8396;2.329681;317;248;14317;41.36;5921;19567
685;37;1989;415;509;40;7;20874;8971;2.326831;375;939;14688;38.92;5717;20881
686;37;1990;421;619;43;116;22002;8354;2.633708;378;859;15226;45.13;6872;22118
687;37;1991;411;466;44;118;23340;8763;2.663471;367;973;15845;44.7;7082;23458
688;37;1992;431;556;44;125;24815;9157;2.709949;387;1095;16524;44.58;7367;24940
689;37;1993;432;910;62;128;26704;9764;2.734945;370;1522;17077;42.82;7313;26832
690;37;1994;469;1067;67;145;28882;10754;2.685698;402;1793;17987;40.21;7233;29027
691;37;1995;436;1019;62;145;30738;11291;2.722345;374;1482;19054;40.74;7763;30883
692;37;1996;492;972;75;150;32778;11906;2.753066;417;1628;20073;40.69;8167;32928
693;37;1997;599;1477;62;156;35050;12652;2.770313;537;1741;21044;39.88;8392;35206
694;37;1998;630;1125;60;156;37458;13334;2.80921;570;1838;22521;40.79;9187;37614
695;37;1999;645;864;49;156;39753;13590;2.925166;596;1699;23646;42.53;10056;39909
696;37;2000;774;165;80;353;42936;15751;2.725922164;694;2685;25145;37.36;9394;43289
697;37;2001;785;661;64;353;44087;16146;2.730521491;721;430;25966;37.82;9820;44440
698;37;2002;769;533;87;353;44747;16378;2.732140677;682;-22;26510;38.22;10132;45100
699;37;2003;830;659;88;353;45405;16600;2.735240964;742;-84;27274;39.14;10674;45758
700;37;2004;794;489;90;353;46132;16849;2.737966645;704;23;27864;39.53;11015;46485
701;37;2005;769;727;89;353;46925;17124;2.740306003;680;113;28711;40.36;11587;47278
702;37;2006;851;745;98;353;47861;17448;2.743065108;753;183;29573;41;12125;48214
703;37;2007;872;578;84;353;48931;17818;2.746155573;788;282;30271;41.14;12453;49284
704;37;2008;858;520;104;353;49948;18181;2.747263627;754;263;30917;41.19;12736;50301
705;37;2009;871;164;93;366;51154;18612;2.748441865;778;441;31165;40.28;12553;51520
706;37;2010;775;19.16;96;55;52002;19184;2.710696414;679;-142;31330;38.77;12146;52057
707;37;2011;650;57;83;70;51948;19161;2.711131987;567;-606;31385;38.95;12224;52018
708;37;2012;695;51;100;70;52240;19268;2.711231057;595;-303;31434;38.7;12166;52310
709;37;2013;602;90;120;70;52731;19441;2.712360475;482;9;31515;38.31;12074;52801
710;37;2014;659;105;121;70;53199;19610;2.712850586;538;-70;31617;37.98;12007;53269
711;37;2015;642;243;111;70;53770;19825;2.71223203;531;40;31862;37.78;12037;53840
712;37;2016;664;182.88;121;70;54465;20093;2.710645498;543;152;32035;37.28;11942;54535
713;37;2017;607;309.38;126;70;54842;20266;2.706108754;481;-104;32502;37.65;12236;54912
714;37;2018;575;420.08;140;70;54793;20272;2.702890687;435;-484;32844;38.28;12572;54863
715;39;1985;109;184;42;35;8525;2908;2.931568;67;233;3520;17.39;612;8560
716;39;1986;129;225;49;35;8758;3007;2.912537;80;153;3712;18.99;705;8793
717;39;1987;147;160;40;37;9303;3199;2.908096;107;440;3945;18.91;746;9340
718;39;1988;125;137;43;37;9792;3370;2.905638;82;407;4110;18;740;9829
719;39;1989;122;100;56;36;9689;3349;2.893102;66;-170;4243;21.07;894;9725
720;39;1990;156;97;51;45;9718;3377;2.877702;105;-67;3997;15.51;620;9763
721;39;1991;141;102;53;46;10222;3637;2.810558;88;417;4094;11.16;457;10268
722;39;1992;152;194;51;47;10719;3662;2.927089;101;397;4196;12.73;534;10766
723;39;1993;111;368;53;52;11490;4084;2.813418;58;718;4390;6.97;306;11542
724;39;1994;155;558;66;61;12786;4537;2.818162;89;1216;4758;4.64;221;12847
725;39;1995;179;494;53;54;14274;5081;2.809289;126;1355;5316;4.42;235;14328
726;39;1996;182;418;60;52;15754;5652;2.787332;122;1356;5835;3.14;183;15806
727;39;1997;192;316;75;56;16931;6139;2.757941;117;1064;6253;1.82;114;16987
728;39;1998;217;311;69;56;17976;6538;2.749465;148;897;6569;0.47;31;18032
729;39;1999;216;291;63;56;19031;6866;2.771774;153;902;6880;0.2;14;19087
730;39;2000;208;77;91;35;20069;6859;2.925936725;117;901;7186;4.55;327;20104
731;39;2001;256;308;83;35;21259;7311;2.907810149;173;1017;7486;2.34;175;21294
732;39;2002;236;297;91;35;21569;7464;2.889737406;145;165;7772;3.96;308;21604
733;39;2003;214;191;89;37;21896;7624;2.871983211;125;204;7948;4.08;324;21933
734;39;2004;215;162;111;47;21994;7709;2.853028927;104;4;8099;4.82;390;22041
735;39;2005;202;213;89;53;22206;7832;2.835291113;113;105;8297;5.6;465;22259
736;39;2006;196;248;86;53;22474;7979;2.81664369;110;158;8535;6.51;556;22527
737;39;2007;204;232;94;53;22425;8015;2.797878977;110;-159;8756;8.46;741;22478
738;39;2008;164;142;124;53;22610;8135;2.779348494;40;145;8887;8.46;752;22663
739;39;2009;185;55;117;53;22837;8273;2.76042548;68;159;8916;7.21;643;22890
740;39;2010;163;9.75;107;73;23034;8388;2.746065808;56;161;8949;6.27;561;23107
741;39;2011;174;33;107;73;23063;8398;2.746249107;67;-38;8981;6.49;583;23136
742;39;2012;171;30;116;73;23171;8437;2.74635534;55;53;9010;6.36;573;23244
743;39;2013;156;44;133;73;23429;8532;2.746015002;23;235;9053;5.75;521;23502
744;39;2014;179;78;120;73;23924;8711;2.746412582;59;436;9129;4.58;418;23997
745;39;2015;208;115;138;73;24514;8927;2.746051305;70;520;9241;3.4;314;24587
746;39;2016;201;150;124;73;25019;9109;2.746624218;77;428;9387;2.96;278;25092
747;39;2017;222;120;154;73;25628;9330;2.746838156;68;541;9505;1.84;175;25701
748;39;2018;197;163;149;73;26145;9518;2.746900609;48;469;9666;1.53;148;26218
749;41;1985;7055;6499;1851;17384;351122;133562;2.628906;5204;8645;149466;10.64;15904;368506
750;41;1986;7592;6364;2010;17872;361432;138529;2.609071;5582;5216;156153;11.29;17624;379304
751;41;1987;7642;2661;2118;18554;374166;144240;2.594052;5524;7892;162616;11.3;18376;392720
752;41;1988;7657;1525;2068;20592;374673;145431;2.576294;5589;-3044;165354;12.05;19923;395265
753;41;1989;7613;854;2172;19366;376948;147299;2.559067;5441;-4392;166667;11.62;19368;396314
754;41;1990;7343;1025;2134;15554;382333;146965;2.601524;5209;-3636;165056;10.96;18091;397887
755;41;1991;7289;1187;2260;15447;390507;147907;2.64022;5029;3038;166081;10.94;18174;405954
756;41;1992;7498;2789;2204;16052;406763;154318;2.635875;5294;11567;167268;7.74;12950;422815
757;41;1993;7479;3682;2324;16644;420491;160771;2.615465;5155;9165;170159;5.52;9388;437135
758;41;1994;7444;3764;2326;17237;439263;166447;2.639056;5118;14247;173741;4.2;7294;456500
759;41;1995;7763;4723;2432;17822;451871;170856;2.644748;5331;7862;177505;3.75;6649;469693
760;41;1996;7611;5291;2558;17627;459362;174384;2.634198;5053;2243;182530;4.46;8146;476989
761;41;1997;7744;4792;2694;19211;467594;178758;2.615793;5050;4766;187987;4.91;9229;486805
762;41;1998;7738;4953;2729;19539;478482;182589;2.620541;5009;6207;193073;5.43;10484;498021
763;41;1999;8041;5536;2819;19867;488948;186150;2.626634;5222;5572;198250;6.1;12100;508815
764;41;2000;8276;1522;2914;15396;504406;193554;2.606022092;5362;5631;204091;5.16;10537;519802
765;41;2001;8338;6087;2999;15502;520834;200185;2.601763369;5339;11195;211168;5.2;10983;536336
766;41;2002;8703;6923;3125;15428;529812;204070;2.596226785;5578;3326;217845;6.32;13775;545240
767;41;2003;8420;6627;3215;15429;536239;206723;2.593997765;5205;1223;226996;8.93;20273;551668
768;41;2004;8234;5103;3378;15526;542929;209755;2.588395986;4856;1931;233118;10.02;23363;558455
769;41;2005;8543;6318;3252;15560;553762;214275;2.584351884;5291;5576;239367;10.48;25092;569322
770;41;2006;8624;6529;3430;16080;566422;219699;2.578172864;5194;7986;244173;10.02;24474;582502
771;41;2007;8921;4197;3354;16022;572750;222624;2.572723516;5567;703;247960;10.22;25336;588772
772;41;2008;9043;2926;3464;16080;582980;227125;2.566780407;5579;4709;250335;9.27;23210;599060
773;41;2009;8587;1905;3513;16255;592263;231329;2.560262656;5074;4384;251891;8.16;20562;608518
774;41;2010;9002;333.2;3526;19141;608091;237924;2.555820346;5476;13238;253716;6.22;15792;627232
775;41;2011;9231;1387.29;3651;20222;618348;241922;2.555980853;5580;5758;255005;5.13;13083;638570
776;41;2012;9156;1842.93;3781;20001;627398;245415;2.556477803;5375;3454;256752;4.42;11337;647399
777;41;2013;9086;2877.71;3940;20279;636484;248896;2.557228722;5146;4218;259326;4.02;10430;656763
778;41;2014;9181;3377.71;4050;20175;643782;251687;2.55786751;5131;2063;262582;4.15;10895;663957
779;41;2015;9435;3315.61;4160;20568;655095;256056;2.558405193;5275;6431;265769;3.65;9713;675663
780;41;2016;9473;3102.15;4327;21080;668497;261278;2.558565972;5146;8768;268729;2.77;7451;689577
781;41;2017;9474;3492;4674;21024;680520;265849;2.559798984;4800;7167;272129;2.31;6280;701544
782;41;2018;9336;4855;4651;21028;693370;270780;2.560639634;4685;8169;275484;1.71;4704;714398
783;43;1985;364;259;374;2749;28617;10955;2.612232;-10;93;13085;16.28;2130;31366
784;43;1986;401;261;344;2687;28443;10868;2.617133;57;-293;13450;19.2;2582;31130
785;43;1987;364;110;358;2697;28697;10955;2.619534;6;258;13761;20.39;2806;31394
786;43;1988;350;78;415;3583;28310;10830;2.614035;-65;564;13897;22.07;3067;31893
787;43;1989;366;122;399;4037;28077;10732;2.616194;-33;254;14600;26.49;3868;32114
788;43;1990;312;127;429;3903;28297;11713;2.415863;-117;203;13683;14.4;1970;32200
789;43;1991;336;81;402;3734;28503;11609;2.45525;-66;103;13837;16.1;2228;32237
790;43;1992;357;169;407;3911;29907;11768;2.541384;-50;1631;13923;15.48;2155;33818
791;43;1993;391;209;420;5854;30653;12579;2.436839;-29;2718;14105;10.82;1526;36507
792;43;1994;384;277;396;6831;31874;12565;2.536729;-12;2210;14336;12.35;1771;38705
793;43;1995;418;336;479;8080;32442;12776;2.539292;-61;1878;14635;12.7;1859;40522
794;43;1996;448;241;514;11970;29858;11726;2.546307;-66;1372;14971;21.68;3245;41828
795;43;1997;444;327;448;8295;34549;13489;2.561272;-4;1020;15212;11.33;1723;42844
796;43;1998;406;356;470;8745;35068;13666;2.566076;-64;1033;15539;12.05;1873;43813
797;43;1999;445;416;476;9195;35949;13930;2.580689;-31;1362;15895;12.36;1965;45144
798;43;2000;473;94;462;9143;37227;15344;2.426160063;11;1224;17230;10.95;1886;46370
799;43;2001;446;374;479;9061;37672;15616;2.412397541;-33;396;17347;9.98;1731;46733
800;43;2002;404;360;464;9109;37860;15781;2.39908751;-60;296;17559;10.13;1778;46969
801;43;2003;420;239;516;9164;37664;15783;2.386365076;-96;-45;17692;10.79;1909;46828
802;43;2004;401;296;494;9280;37260;15701;2.373097255;-93;-195;17975;12.65;2274;46540
803;43;2005;402;215;493;9243;37204;15764;2.360060898;-91;-2;18191;13.34;2427;46447
804;43;2006;439;262;483;9219;37484;15969;2.34729789;-44;300;18444;13.42;2475;46703
805;43;2007;422;235;516;9197;37457;16045;2.334496728;-94;45;18685;14.13;2640;46654
806;43;2008;425;154;458;9347;37427;16124;2.321198214;-33;153;18925;14.8;2801;46774
807;43;2009;413;91;491;9305;37330;16169;2.308738945;-78;-61;19104;15.36;2935;46635
808;43;2010;373;11.5;504;8704;38150;16594;2.299023744;-131;350;19256;13.82;2662;46854
809;43;2011;379;53;528;9058;38370;16589;2.31297848;-149;723;19344;14.24;2755;47428
810;43;2012;388;46;498;8681;38407;16604;2.313117321;-110;-230;19388;14.36;2784;47088
811;43;2013;335;52;529;8364;37970;16417;2.31284644;-194;-560;19439;15.55;3022;46334
812;43;2014;380;53;541;8211;37935;16402;2.312827704;-161;-27;19490;15.84;3088;46146
813;43;2015;381;55;546;8151;38144;16491;2.313019223;-165;314;19543;15.62;3052;46295
814;43;2016;379;54;541;8299;38715;16738;2.313000358;-162;881;19592;14.57;2854;47014
815;43;2017;379;85;575;8443;39173;16938;2.312728776;-196;798;19696;14;2758;47616
816;43;2018;375;119;562;8319;39598;17121;2.312832194;-187;488;19819;13.61;2698;47917
817;45;1985;467;56;172;444;25270;9426;2.680883;295;-238;12647;25.47;3221;25714
818;45;1986;441;22;173;448;25743;9638;2.67099;268;209;12265;21.42;2627;26191
819;45;1987;424;68;193;451;25936;9728;2.666118;231;-35;12078;19.46;2350;26387
820;45;1988;418;111;178;645;26680;9944;2.683025;240;698;12166;18.26;2222;27325
821;45;1989;445;182;206;725;28084;10490;2.677216;239;1245;12290;14.65;1800;28809
822;45;1990;493;216;192;691;29460;11266;2.614948;301;1041;12517;9.99;1251;30151
823;45;1991;495;132;210;721;30509;11812;2.582882;285;794;12733;7.23;921;31230
824;45;1992;462;327;188;714;30625;11868;2.580468;274;-165;12880;7.86;1012;31339
825;45;1993;426;376;204;749;31825;12142;2.621067;222;1013;13220;8.15;1078;32574
826;45;1994;465;533;212;768;33728;12737;2.648033;253;1669;13648;6.67;911;34496
827;45;1995;498;406;229;807;35610;13407;2.656075;269;1652;14181;5.46;774;36417
828;45;1996;561;384;230;837;36840;13876;2.654944;331;929;14695;5.57;819;37677
829;45;1997;603;403;250;876;38018;14332;2.652665;353;864;15131;5.28;799;38894
830;45;1998;580;497;237;961;40270;14936;2.69617;343;1994;15534;3.85;598;41231
831;45;1999;676;635;256;1046;41645;15455;2.694597;420;1040;16097;3.99;642;42691
832;45;2000;733;164;242;849;43391;16387;2.647891621;491;1055;17521;6.47;1134;44240
833;45;2001;796;655;269;850;45057;16962;2.656349487;527;1140;18229;6.95;1267;45907
834;45;2002;811;546;282;848;45880;17228;2.663106571;529;292;18927;8.98;1699;46728
835;45;2003;866;508;288;849;46635;17459;2.671115184;578;178;19525;10.58;2066;47484
836;45;2004;811;356;275;843;47313;17660;2.679105323;536;136;20008;11.74;2348;48156
837;45;2005;832;485;271;848;48408;18011;2.687690856;561;539;20598;12.56;2587;49256
838;45;2006;893;569;274;852;50254;18643;2.695596202;619;1231;21230;12.19;2587;51106
839;45;2007;971;718;290;847;51829;19162;2.704780294;681;889;22106;13.32;2944;52676
840;45;2008;975;574;286;830;53396;19680;2.713211382;689;861;22805;13.7;3125;54226
841;45;2009;997;385;268;851;54549;20048;2.720919792;729;445;23145;13.38;3097;55400
842;45;2010;912;19.5;278;884;55266;20272;2.726223362;634;116;23327;13.1;3055;56150
843;45;2011;863;37;294;868;55242;20263;2.726249815;569;-609;23363;13.27;3100;56110
844;45;2012;788;33;252;884;55965;20526;2.726541947;536;203;23395;12.26;2869;56849
845;45;2013;822;96;281;849;56179;20610;2.725812712;541;-362;23486;12.25;2876;57028
846;45;2014;773;76;288;883;56385;20685;2.725888325;485;-245;23560;12.2;2875;57268
847;45;2015;767;83;338;875;56954;20890;2.726376257;429;132;23638;11.63;2748;57829
848;45;2016;839;144;337;884;58079;21301;2.726585606;502;632;23774;10.4;2473;58963
849;45;2017;823;166;322;880;58293;21378;2.726775189;501;-291;23932;10.67;2554;59173
850;45;2018;781;194;340;880;58932;21606;2.727575673;441;198;24124;10.44;2518;59812
851;47;1985;41;36;17;51;3030;1128;2.68617;24;31;2185;48.38;1057;3081
852;47;1986;41;24;12;53;3184;1170;2.721368;29;127;2219;47.27;1049;3237
853;47;1987;58;16;10;53;3226;1162;2.776248;48;-6;2240;48.13;1078;3279
854;47;1988;41;16;13;51;3121;1110;2.811712;28;-135;2256;50.8;1146;3172
855;47;1989;41;20;10;50;3064;1078;2.842301;31;-89;2265;52.41;1187;3114
856;47;1990;34;16;11;2;3067;1308;2.344801;23;-68;2438;46.35;1130;3069
857;47;1991;31;17;15;2;3087;1327;2.3263;16;4;2454;45.93;1127;3089
858;47;1992;32;34;22;2;3242;1382;2.345876;10;145;2471;44.07;1089;3244
859;47;1993;40;32;13;2;3374;1438;2.346314;27;105;2505;42.59;1067;3376
860;47;1994;37;58;14;2;3497;1487;2.351715;23;100;2537;41.39;1050;3499
861;47;1995;45;67;16;2;3666;1561;2.348495;29;140;2595;39.85;1034;3668
862;47;1996;48;254;13;2;3790;1618;2.342398;35;89;2662;39.22;1044;3792
863;47;1997;41;80;14;3;4032;1750;2.304;27;216;2916;39.99;1166;4035
864;47;1998;48;86;13;3;4243;1841;2.304726;35;176;2996;38.55;1155;4246
865;47;1999;46;81;16;3;4535;1937;2.341249;30;262;3082;37.15;1145;4538
866;47;2000;72;20;17;24;4779;2066;2.313165537;55;210;2950;29.97;884;4803
867;47;2001;57;81;15;24;4805;2088;2.301245211;42;-16;3035;31.2;947;4829
868;47;2002;66;63;26;24;4806;2099;2.289661744;40;-39;3102;32.33;1003;4830
869;47;2003;53;69;31;24;4827;2118;2.279036827;22;-1;3175;33.29;1057;4851
870;47;2004;56;54;26;46;4779;2107;2.268153773;30;-56;3234;34.85;1127;4825
871;47;2005;55;73;20;52;4840;2145;2.256410256;35;32;3312;35.24;1167;4892
872;47;2006;73;83;28;45;4908;2190;2.24109589;45;16;3401;35.61;1211;4953
873;47;2007;58;72;19;37;4927;2211;2.228403437;39;-28;3479;36.45;1268;4964
874;47;2008;49;39;30;37;5047;2279;2.214567793;19;101;3524;35.33;1245;5084
875;47;2009;52;44;26;37;5359;2435;2.200821355;26;286;3545;31.31;1110;5396
876;47;2010;47;4;25;49;5414;2471;2.191015783;22;45;3564;30.67;1093;5463
877;47;2011;47;4;28;49;5371;2450;2.192244898;19;-62;3568;31.33;1118;5420
878;47;2012;39;16;27;49;5373;2452;2.191272431;12;-10;3584;31.58;1132;5422
879;47;2013;48;8;21;49;5473;2497;2.191830196;27;73;3592;30.48;1095;5522
880;47;2014;40;14;30;49;5690;2597;2.190989603;10;207;3606;27.98;1009;5739
881;47;2015;39;13;34;49;5746;2622;2.191456903;5;51;3619;27.55;997;5795
882;47;2016;42;16;30;49;5854;2672;2.190868263;12;96;3635;26.49;963;5903
883;47;2017;40;31;30;49;5953;2725;2.184587156;10;89;3675;25.85;950;6002
884;47;2018;42;34;23;49;6049;2767;2.186122154;19;77;3708;25.38;941;6098
885;49;1985;144;160;41;9;9203;3751;2.453479;103;218;9948;62.29;6197;9212
886;49;1986;157;96;30;9;9130;3785;2.412153;127;-200;10113;62.57;6328;9139
887;49;1987;122;77;37;9;8899;3749;2.3737;85;-316;10213;63.29;6464;8908
888;49;1988;104;44;29;9;8458;3620;2.336464;75;-516;10301;64.86;6681;8467
889;49;1989;110;38;40;9;8169;3556;2.297244;70;-359;10305;65.49;6749;8178
890;49;1990;120;63;32;75;7931;3168;2.503472;88;-260;9985;68.27;6817;8006
891;49;1991;100;61;35;73;8316;3129;2.657718;65;318;10048;68.86;6919;8389
892;49;1992;90;89;33;72;8532;3046;2.801051;57;158;10109;69.87;7063;8604
893;49;1993;86;129;40;80;8845;3376;2.619964;46;275;10198;66.9;6822;8925
894;49;1994;91;273;40;82;9257;3465;2.671573;51;363;10327;66.45;6862;9339
895;49;1995;117;247;33;87;9866;3645;2.706722;84;530;10600;65.61;6955;9953
896;49;1996;111;282;44;90;10421;3808;2.736607;67;491;10847;64.89;7039;10511
897;49;1997;124;364;42;92;10874;3949;2.753608;82;373;11129;64.52;7180;10966
898;49;1998;134;644;42;92;11317;4055;2.790875;92;351;11493;64.72;7438;11409
899;49;1999;136;485;55;92;11903;4208;2.82866;81;505;12137;65.33;7929;11995
900;49;2000;150;132;59;393;12460;5255;2.371075167;91;766;12198;56.92;6943;12853
901;49;2001;153;529;62;393;12890;5464;2.359077599;91;339;12716;57.03;7252;13283
902;49;2002;159;466;67;393;13068;5562;2.349514563;92;86;13169;57.76;7607;13461
903;49;2003;163;348;54;393;13295;5682;2.339845125;109;118;13267;57.17;7585;13688
904;49;2004;142;432;40;393;13519;5798;2.331666092;102;122;13662;57.56;7864;13912
905;49;2005;146;513;73;393;13504;5813;2.323068983;73;-88;14074;58.7;8261;13897
906;49;2006;139;606;59;393;13742;5939;2.313857552;80;158;14541;59.16;8602;14135
907;49;2007;170;792;49;393;13946;6053;2.303981497;121;83;15327;60.51;9274;14339
908;49;2008;156;574;57;393;14142;6163;2.294661691;99;97;15786;60.96;9623;14535
909;49;2009;145;313;54;393;14271;6248;2.284090909;91;38;15980;60.9;9732;14664
910;49;2010;138;35;44;222;14568;6444;2.260707635;94;32;16094;59.96;9650;14790
911;49;2011;106;64.37;66;222;14336;6342;2.260485651;40;-272;16175;60.79;9833;14558
912;49;2012;111;49.26;45;222;13995;6188;2.261635423;66;-407;16302;62.04;10114;14217
913;49;2013;117;33.64;61;222;14086;6230;2.260995185;56;35;16365;61.93;10135;14308
914;49;2014;123;39.35;66;222;14334;6359;2.253773585;57;191;16391;61.2;10032;14556
915;49;2015;113;68.53;77;222;14498;6442;2.25054331;36;128;16454;60.85;10012;14720
916;49;2016;127;130.43;66;222;14947;6647;2.243620534;61;388;16579;59.91;9932;15169
917;49;2017;129;158.02;67;222;15127;6725;2.244362018;62;118;16732;59.81;10007;15349
918;49;2018;107;198;85;222;15259;6785;2.243970588;22;110;16921;59.9;10136;15481
919;51;1985;140;87;50;1399;8991;4072;2.208006;90;-117;7165;43.17;3093;10390
920;51;1986;149;117;51;1472;9418;4368;2.156136;98;402;7243;39.69;2875;10890
921;51;1987;126;119;58;1485;9370;4448;2.106565;68;-103;7350;39.48;2902;10855
922;51;1988;129;126;52;1032;9795;4525;2.164641;77;-105;7477;39.48;2952;10827
923;51;1989;126;123;36;989;9520;4507;2.11227;90;-408;7544;40.26;3037;10509
924;51;1990;127;163;47;1087;9194;3855;2.384955;80;-308;7294;47.15;3439;10281
925;51;1991;124;166;47;1078;9338;3984;2.343875;77;58;7457;46.57;3473;10416
926;51;1992;122;233;50;1139;9637;4274;2.254797;72;288;7623;43.93;3349;10776
927;51;1993;138;257;57;1327;9984;4325;2.308439;81;454;7856;44.95;3531;11311
928;51;1994;124;339;43;1235;10436;4565;2.28609;81;279;8113;43.73;3548;11671
929;51;1995;91;325;59;1182;10792;4721;2.285956;32;271;8452;44.14;3731;11974
930;51;1996;129;235;49;1110;11134;4872;2.285304;80;190;8777;44.49;3905;12244
931;51;1997;118;276;61;1074;11331;4992;2.269832;57;104;9012;44.61;4020;12405
932;51;1998;134;260;33;1079;12363;5083;2.432225;101;936;9288;45.27;4205;13442
933;51;1999;130;309;48;1084;12652;5472;2.312135;82;212;9660;43.35;4188;13736
934;51;2000;155;80;53;975;13014;5667;2.29645315;102;151;9222;38.55;3555;13989
935;51;2001;186;321;66;1039;13306;5810;2.290189329;120;236;9571;39.3;3761;14345
936;51;2002;171;194;71;1113;13203;5786;2.281887314;100;-129;9793;40.92;4007;14316
937;51;2003;178;194;73;1066;13140;5775;2.275324675;105;-215;10020;42.37;4245;14206
938;51;2004;165;191;70;897;13333;5884;2.265975527;95;-71;10244;42.56;4360;14230
939;51;2005;168;192;73;839;13634;6035;2.25915493;95;148;10456;42.28;4421;14473
940;51;2006;158;262;51;841;13809;6134;2.251222693;107;70;10738;42.88;4604;14650
941;51;2007;162;243;49;830;14127;6298;2.243093045;113;194;11002;42.76;4704;14957
942;51;2008;168;173;66;808;14329;6412;2.234716157;102;78;11214;42.82;4802;15137
943;51;2009;182;87;59;808;14458;6493;2.227048675;123;6;11338;42.74;4846;15266
944;51;2010;158;21.75;69;850;14459;6511;2.220703425;89;-46;11431;43.04;4920;15309
945;51;2011;152;73;58;868;14539;6546;2.221051024;94;4;11452;42.84;4906;15407
946;51;2012;164;50;74;824;14568;6560;2.220731707;90;-105;11467;42.79;4907;15392
947;51;2013;149;47;65;1002;14605;6577;2.220617303;84;131;11486;42.74;4909;15607
948;51;2014;136;64;54;991;14808;6669;2.220422852;82;110;11512;42.07;4843;15799
949;51;2015;138;58;79;989;15142;6820;2.220234604;59;273;11533;40.87;4713;16131
950;51;2016;158;101;79;1019;15429;6950;2.22;79;238;11565;39.9;4615;16448
951;51;2017;135;103;67;1032;15852;7140;2.220168067;68;368;11663;38.78;4523;16884
952;51;2018;126;142;81;1032;16141;7271;2.21991473;45;244;11799;38.38;4528;17173
953;53;1985;5;20;0;0;472;168;2.809524;5;-116;888;81.08;720;472
954;53;1986;6;4;3;0;468;165;2.836364;3;-7;908;81.83;743;468
955;53;1987;8;15;0;0;508;176;2.886364;6;32;913;80.72;737;508
956;53;1988;3;19;4;0;489;166;2.945783;-1;-18;929;82.13;763;489
957;53;1989;5;10;4;0;476;160;2.975;1;-14;987;83.79;827;476
958;53;1990;3;13;3;0;463;214;2.163551;0;-13;1254;82.93;1040;463
959;53;1991;3;7;0;0;453;199;2.276382;3;-13;1267;84.29;1068;453
960;53;1992;4;12;0;0;504;210;2.4;4;47;1274;83.52;1064;504
961;53;1993;9;19;0;0;546;245;2.228571;9;33;1286;80.95;1041;546
962;53;1994;5;32;0;0;612;274;2.233577;5;61;1305;79;1031;612
963;53;1995;3;17;4;0;659;294;2.241497;-1;48;1337;78.01;1043;659
964;53;1996;7;29;3;0;707;314;2.251592;4;44;1354;76.81;1040;707
965;53;1997;4;20;4;0;739;330;2.239394;0;32;1383;76.14;1053;739
966;53;1998;6;13;0;0;776;345;2.249275;6;31;1403;75.41;1058;776
967;53;1999;8;13;4;0;784;345;2.272464;4;4;1416;75.64;1071;784
968;53;2000;12;4;0;0;792;360;2.2;12;-7;1307;72.46;947;792
969;53;2001;6;15;4;0;804;366;2.196721311;2;10;1316;72.19;950;804
970;53;2002;10;16;5;0;806;367;2.196185286;5;-3;1325;72.3;958;806
971;53;2003;5;14;1;0;784;358;2.189944134;4;-26;1333;73.14;975;784
972;53;2004;8;8;1;0;831;380;2.186842105;7;40;1335;71.54;955;831
973;53;2005;8;15;2;0;813;372;2.185483871;6;-24;1343;72.3;971;813
974;53;2006;7;17;5;0;830;380;2.184210526;2;15;1356;71.98;976;830
975;53;2007;9;12;1;0;845;388;2.177835052;8;7;1363;71.53;975;845
976;53;2008;8;27;2;0;824;378;2.17989418;6;-27;1383;72.67;1005;824
977;53;2009;10;17;2;0;827;380;2.176315789;8;-5;1386;72.58;1006;827
978;53;2010;10;2.25;4;56;787;362;2.174033149;6;10;1391;73.98;1029;843
979;53;2011;5;1;7;56;768;353;2.175637394;-2;-17;1392;74.64;1039;824
980;53;2012;6;6.12;3;56;745;342;2.178362573;3;-26;1398;75.54;1056;801
981;53;2013;10;2.72;5;56;748;344;2.174418605;5;-2;1401;75.45;1057;804
982;53;2014;6;4.08;4;56;715;329;2.17325228;2;-35;1405;76.58;1076;771
983;53;2015;7;4.08;5;56;708;325;2.178461538;2;-9;1409;76.93;1084;764
984;53;2016;2;6;4;56;730;335;2.179104478;-2;24;1415;76.33;1080;786
985;53;2017;4;7;4;56;735;338;2.174556213;0;5;1422;76.23;1084;791
986;53;2018;1;8;7;56;751;346;2.170520231;-6;22;1430;75.8;1084;807
987;55;1985;85;38;81;144;6665;2778;2.399208;4;165;4123;32.62;1345;6809
988;55;1986;83;31;80;144;6608;2811;2.350765;3;-60;4179;32.74;1368;6752
989;55;1987;71;70;69;142;6358;2757;2.30613;2;-254;4227;34.78;1470;6500
990;55;1988;78;18;68;138;6154;2722;2.260838;10;-218;4302;36.73;1580;6292
991;55;1989;59;17;86;137;5993;2704;2.216346;-27;-135;4334;37.61;1630;6130
992;55;1990;61;11;71;116;5888;2446;2.407195;-10;-116;3913;37.49;1467;6004
993;55;1991;59;14;81;108;5949;2307;2.578674;-22;75;3929;41.28;1622;6057
994;55;1992;59;23;67;109;6072;2306;2.633131;-8;132;3943;41.52;1637;6181
995;55;1993;69;26;88;123;6316;2597;2.432037;-19;277;3966;34.52;1369;6439
996;55;1994;67;60;70;132;6791;2777;2.445445;-3;487;3992;30.44;1215;6923
997;55;1995;62;71;88;136;7026;2865;2.452356;-26;265;4052;29.29;1187;7162
998;55;1996;50;96;89;140;7249;2951;2.456455;-39;266;4123;28.43;1172;7389
999;55;1997;65;107;84;145;7527;3077;2.446214;-19;302;4219;27.07;1142;7672
1000;55;1998;64;109;102;892;6889;2823;2.440312;-38;147;4326;34.74;1503;7781
1001;55;1999;70;115;97;1639;6188;2535;2.441026;-27;73;4435;42.84;1900;7827
1002;55;2000;71;23;92;919;6908;3072;2.248697917;-21;18;4620;33.51;1548;7827
1003;55;2001;74;93;89;1061;6844;3065;2.232952692;-15;93;4705;34.86;1640;7905
1004;55;2002;83;90;98;1035;6881;3104;2.21681701;-15;26;4787;35.16;1683;7916
1005;55;2003;79;60;112;1165;6877;3126;2.19993602;-33;159;4837;35.37;1711;8042
1006;55;2004;73;50;88;1086;6643;3043;2.18304305;-15;-298;4878;37.62;1835;7729
1007;55;2005;61;51;95;1167;6656;3073;2.165961601;-34;128;4918;37.52;1845;7823
1008;55;2006;58;38;92;1173;6577;3059;2.150049036;-34;-39;4946;38.15;1887;7750
1009;55;2007;58;47;92;1167;6491;3043;2.133092343;-34;-58;4984;38.94;1941;7658
1010;55;2008;59;62;119;1183;6497;3071;2.115597525;-60;82;5035;39.01;1964;7680
1011;55;2009;56;32;108;418;6292;2998;2.098732488;-52;-918;5056;40.7;2058;6710
1012;55;2010;56;8.75;102;165;6490;3110;2.08681672;-46;-9;5084;38.83;1974;6655
1013;55;2011;46;30;105;165;6339;3037;2.087257162;-59;-92;5113;40.6;2076;6504
1014;55;2012;59;30;106;165;6377;3055;2.087397709;-47;85;5141;40.58;2086;6542
1015;55;2013;50;24;88;165;6282;3010;2.087043189;-38;-57;5162;41.69;2152;6447
1016;55;2014;41;15;97;165;6211;2976;2.08702957;-56;-15;5170;42.44;2194;6376
1017;55;2015;55;14;104;165;6220;2981;2.086548138;-49;58;5182;42.47;2201;6385
1018;55;2016;44;32;109;165;6398;3065;2.087438825;-65;243;5210;41.17;2145;6563
1019;55;2017;44;31;117;165;6446;3089;2.086759469;-73;121;5239;41.04;2150;6611
1020;55;2018;45;42;100;165;6686;3205;2.086115445;-55;295;5285;39.36;2080;6851
1021;57;1985;28;7;7;19;1710;600;2.85;21;-85;1166;48.54;566;1729
1022;57;1986;19;8;7;18;1690;592;2.85473;12;-33;1170;49.4;578;1708
1023;57;1987;20;12;12;19;1756;612;2.869281;8;59;1175;47.91;563;1775
1024;57;1988;17;5;16;18;1695;588;2.882653;1;-63;1189;50.55;601;1713
1025;57;1989;21;6;9;17;1634;566;2.886926;12;-74;1232;54.06;666;1651
1026;57;1990;23;11;14;11;1586;632;2.509494;9;-63;1326;52.34;694;1597
1027;57;1991;16;2;7;10;1546;619;2.497577;9;-50;1337;53.7;718;1556
1028;57;1992;22;3;11;10;1564;603;2.593698;11;7;1339;54.97;736;1574
1029;57;1993;21;6;16;12;1620;673;2.407132;5;53;1342;49.85;669;1632
1030;57;1994;22;13;16;12;1630;682;2.390029;6;4;1348;49.41;666;1642
1031;57;1995;13;17;10;12;1597;679;2.351988;3;-36;1361;50.11;682;1609
1032;57;1996;12;25;11;12;1582;685;2.309489;1;-16;1378;50.29;693;1594
1033;57;1997;16;14;11;12;1584;701;2.259629;5;-3;1403;50.04;702;1596
1034;57;1998;16;17;16;12;1575;708;2.224576;0;-9;1417;50.04;709;1587
1035;57;1999;18;16;11;12;1570;717;2.189679;7;-12;1434;50;717;1582
1036;57;2000;12;6;7;10;1566;662;2.365558912;5;-9;1151;42.48;489;1576
1037;57;2001;17;23;18;10;1580;675;2.340740741;-1;15;1176;42.6;501;1590
1038;57;2002;18;16;10;10;1581;680;2.325;8;-7;1193;43;513;1591
1039;57;2003;12;9;12;10;1576;685;2.300729927;0;-5;1204;43.11;519;1586
1040;57;2004;10;14;8;10;1511;664;2.27560241;2;-67;1219;45.53;555;1521
1041;57;2005;9;10;12;10;1482;657;2.255707763;-3;-26;1231;46.63;574;1492
1042;57;2006;15;13;12;10;1433;642;2.232087227;3;-52;1246;48.48;604;1443
1043;57;2007;12;12;11;10;1412;638;2.213166144;1;-22;1260;49.37;622;1422
1044;57;2008;11;8;13;10;1371;627;2.186602871;-2;-39;1270;50.63;643;1381
1045;57;2009;8;12;14;10;1376;636;2.163522013;-6;11;1280;50.31;644;1386
1046;57;2010;10;1.75;7;2;1385;646;2.143962848;3;-2;1288;49.84;642;1387
1047;57;2011;12;7;10;2;1354;631;2.145800317;2;-33;1295;51.27;664;1356
1048;57;2012;9;2;15;2;1322;616;2.146103896;-6;-26;1297;52.51;681;1324
1049;57;2013;6;2;10;2;1334;622;2.144694534;-4;16;1299;52.12;677;1336
1050;57;2014;17;4;12;2;1383;645;2.144186047;5;44;1303;50.5;658;1385
1051;57;2015;12;5;10;2;1350;629;2.146263911;2;-35;1309;51.95;680;1352
1052;57;2016;12;4;12;2;1355;631;2.147385103;0;5;1313;51.94;682;1357
1053;57;2017;15;7;13;2;1374;640;2.146875;2;17;1320;51.52;680;1376
1054;57;2018;13;9;15;2;1390;647;2.148377125;-2;18;1326;51.21;679;1392
1055;59;1985;6675;4909;2182;6206;415411;148723;2.793186;4493;3441;163850;9.23;15127;421617
1056;59;1986;6811;4801;2149;6216;420854;151297;2.781641;4662;791;168344;10.13;17047;427070
1057;59;1987;6551;2809;2161;6213;423974;152699;2.776534;4390;-1273;173123;11.8;20424;430187
1058;59;1988;6587;1525;2419;6201;426228;153871;2.770035;4168;-1926;175952;12.55;22081;432429
1059;59;1989;6527;1742;2219;5856;430049;155728;2.761539;4308;-832;177967;12.5;22239;435905
1060;59;1990;6711;1734;2419;6482;433403;166545;2.602318;4292;-312;178611;6.76;12066;439885
1061;59;1991;6445;2201;2430;6523;443140;170280;2.60242;4015;5763;180338;5.58;10058;449663
1062;59;1992;6538;3350;2418;6875;456665;175300;2.605048;4120;9757;182919;4.17;7619;463540
1063;59;1993;6513;3761;2597;7055;469153;180710;2.596165;3916;8752;186285;2.99;5575;476208
1064;59;1994;6472;4093;2670;6844;476589;182527;2.61106;3802;3423;189667;3.76;7140;483433
1065;59;1995;6352;5102;2712;6904;484410;185470;2.611797;3640;4241;193161;3.98;7691;491314
1066;59;1996;6229;3576;2796;7073;490973;188494;2.604714;3433;3299;197664;4.64;9170;498046
1067;59;1997;6372;3686;2965;7151;497083;192227;2.585917;3407;2781;201048;4.39;8821;504234
1068;59;1998;6358;3675;3076;7119;505364;194447;2.598981;3282;4967;204371;4.86;9924;512483
1069;59;1999;6301;2924;3030;7087;513723;198498;2.588051;3271;5056;208057;4.59;9559;520810
1070;59;2000;6701;847;3159;7730;518988;206160;2.517403958;3542;2365;212761;3.1;6601;526718
1071;59;2001;6532;3387;3133;7788;520279;207436;2.50814227;3399;-2050;216341;4.12;8905;528067
1072;59;2002;6551;2673;3400;7730;519809;208047;2.498517162;3151;-3679;218986;5;10939;527539
1073;59;2003;6620;2229;3444;7760;517669;208064;2.488027722;3176;-5286;221186;5.93;13122;525429
1074;59;2004;6337;1642;3367;7827;517049;208717;2.477273054;2970;-3523;222899;6.36;14182;524876
1075;59;2005;6183;2535;3338;7797;515720;209058;2.466875221;2845;-4204;224639;6.94;15581;523517
1076;59;2006;6138;2151;3462;7767;516812;210389;2.456459226;2676;-1614;226430;7.08;16041;524579
1077;59;2007;6194;2059;3541;7840;519280;212308;2.445892034;2653;-112;227770;6.79;15463;527120
1078;59;2008;6167;1073;3736;7796;522769;214695;2.434937935;2431;1014;229029;6.26;14334;530565
1079;59;2009;5934;602;3678;7795;524811;216523;2.423811789;2256;-215;229781;5.77;13258;532606
1080;59;2010;5723;101.53;3757;7427;528224;218631;2.416052618;1966;1079;230181;5.02;11550;535651
1081;59;2011;5545;609.62;3744;7723;532839;220539;2.416076068;1801;3110;230772;4.43;10233;540562
1082;59;2012;5565;990.44;3906;7575;539018;223093;2.416113459;1659;4372;231726;3.73;8633;546593
1083;59;2013;5633;1092.92;4003;7763;544440;225330;2.416189589;1630;3980;232765;3.19;7435;552203
1084;59;2014;5917;1643.15;4110;7774;551226;228146;2.416110736;1807;4990;234055;2.52;5909;559000
1085;59;2015;5838;2621.06;4397;7815;557358;230714;2.415796181;1441;4732;236608;2.49;5894;565173
1086;59;2016;5903;1897.15;4322;7987;563723;233413;2.41513112;1581;4956;238399;2.09;4986;571710
1087;59;2017;5977;2600.9;4489;8671;567123;234720;2.4161682;1488;2596;240930;2.58;6210;575794
1088;59;2018;5589;2397.76;4521;8320;571169;236413;2.415979663;1068;2627;242975;2.7;6562;579489
1089;61;1985;24;0;12;29;1818;728;2.497253;12;-123;855;14.85;127;1847
1090;61;1986;22;-1;15;29;1769;717;2.467225;7;-56;844;15.05;127;1798
1091;61;1987;25;0;16;28;1730;709;2.440056;9;-49;833;14.89;124;1758
1092;61;1988;22;-1;10;28;1683;697;2.414634;12;-59;834;16.43;137;1711
1093;61;1989;20;-1;21;28;1670;699;2.389127;-1;-12;904;22.68;205;1698
1094;61;1990;16;0;16;44;1644;657;2.502283;0;-10;878;25.17;221;1688
1095;61;1991;19;0;21;47;1636;704;2.323864;-2;-3;878;19.82;174;1683
1096;61;1992;15;4;19;48;1647;710;2.319718;-4;16;878;19.13;168;1695
1097;61;1993;14;0;19;46;1652;677;2.440177;-5;8;882;23.24;205;1698
1098;61;1994;16;1;24;46;1647;677;2.432792;-8;3;882;23.24;205;1693
1099;61;1995;20;3;10;46;1597;663;2.408748;10;-60;883;24.92;220;1643
1100;61;1996;14;1;19;47;1615;679;2.378498;-5;24;886;23.36;207;1662
1101;61;1997;17;0;25;47;1614;689;2.342525;-8;7;887;22.32;198;1661
1102;61;1998;19;1;18;47;1597;689;2.317852;1;-18;887;22.32;198;1644
1103;61;1999;14;1;13;47;1585;690;2.297101;1;-13;888;22.3;198;1632
1104;61;2000;16;0;14;24;1590;663;2.398190045;2;-14;816;18.75;153;1614
1105;61;2001;16;0;25;24;1582;663;2.38612368;-9;1;813;18.45;150;1606
1106;61;2002;14;1;16;24;1542;651;2.368663594;-2;-38;811;19.73;160;1566
1107;61;2003;23;0;18;24;1524;649;2.348228043;5;-23;809;19.78;160;1548
1108;61;2004;11;0;22;24;1499;643;2.33125972;-11;-14;806;20.22;163;1523
1109;61;2005;16;2;20;28;1515;655;2.312977099;-4;24;805;18.63;150;1543
1110;61;2006;7;1;18;11;1503;655;2.294656489;-11;-18;803;18.43;148;1514
1111;61;2007;22;2;24;18;1453;637;2.28100471;-2;-41;802;20.57;165;1471
1112;61;2008;15;1;22;18;1414;626;2.258785942;-7;-32;801;21.85;175;1432
1113;61;2009;17;3;19;18;1374;611;2.248772504;-2;-38;803;23.91;192;1392
1114;61;2010;6;1.25;19;14;1385;620;2.233870968;-13;20;806;23.08;186;1399
1115;61;2011;20;6;22;14;1413;631;2.239302694;-2;30;813;22.39;182;1427
1116;61;2012;8;1;21;14;1391;621;2.239935588;-13;-9;814;23.71;193;1405
1117;61;2013;15;2;18;14;1374;614;2.237785016;-3;-14;816;24.75;202;1388
1118;61;2014;19;4;20;14;1363;609;2.238095238;-1;-10;820;25.73;211;1377
1119;61;2015;14;0;22;14;1368;611;2.238952537;-8;13;820;25.49;209;1382
1120;61;2016;20;0;21;14;1329;594;2.237373737;-1;-38;820;27.56;226;1343
1121;61;2017;17;0;21;14;1350;604;2.235099338;-4;25;821;26.43;217;1364
1122;61;2018;17;0;24;14;1359;608;2.235197368;-7;16;821;25.94;213;1373
1123;63;1985;119;2;69;70;7477;2930;2.551877;50;-304;3560;17.7;630;7547
1124;63;1986;108;2;75;69;7304;2903;2.516018;33;-207;3552;18.27;649;7373
1125;63;1987;118;4;51;68;7173;2890;2.482007;67;-199;3545;18.48;655;7241
1126;63;1988;119;4;70;69;7211;2941;2.451887;49;-10;3554;17.25;613;7280
1127;63;1989;112;1;74;69;7132;2950;2.417627;38;-117;3580;17.6;630;7201
1128;63;1990;110;3;61;66;7062;2785;2.535727;49;-122;3224;13.62;439;7128
1129;63;1991;120;3;57;64;7097;2733;2.59678;63;-30;3227;15.31;494;7161
1130;63;1992;96;6;64;65;7167;2750;2.606182;32;39;3230;14.86;480;7232
1131;63;1993;107;-1;54;66;7201;2812;2.560811;53;-18;3236;13.1;424;7267
1132;63;1994;96;20;80;67;7273;2821;2.578164;16;57;3235;12.8;414;7340
1133;63;1995;75;20;68;68;7345;2846;2.580815;7;66;3255;12.57;409;7413
1134;63;1996;83;18;73;69;7417;2875;2.579826;10;63;3275;12.21;400;7486
1135;63;1997;67;15;66;70;7529;2935;2.565247;1;112;3293;10.87;358;7599
1136;63;1998;75;32;77;70;7684;2984;2.575067;-2;157;3308;9.79;324;7754
1137;63;1999;101;57;71;70;7831;3034;2.581081;30;117;3340;9.16;306;7901
1138;63;2000;100;8;85;531;7444;2979;2.498825109;15;59;3437;13.33;458;7975
1139;63;2001;107;31;69;598;7475;3007;2.485866312;38;60;3469;13.32;462;8073
1140;63;2002;80;14;85;765;7524;3046;2.470935961;-5;221;3482;12.55;437;8289
1141;63;2003;78;17;67;788;7397;3009;2.457475083;11;-115;3497;13.93;487;8185
1142;63;2004;90;5;72;964;7293;2985;2.44321608;18;54;3503;14.79;518;8257
1143;63;2005;108;6;68;1000;6998;2881;2.429017702;40;-299;3509;17.9;628;7998
1144;63;2006;98;11;92;1035;6911;2861;2.415588955;6;-58;3519;18.7;658;7946
1145;63;2007;92;2;80;1024;6811;2836;2.401622003;12;-123;3520;19.43;684;7835
1146;63;2008;101;6;67;1334;6708;2807;2.389739936;34;173;3525;20.37;718;8042
1147;63;2009;102;1;76;1508;6761;2846;2.375614898;26;201;3526;19.29;680;8269
1148;63;2010;108;0.25;81;1075;7192;3038;2.367346939;27;-29;3527;13.86;489;8267
1149;63;2011;105;2;83;874;7289;3077;2.368865778;22;-126;3529;12.81;452;8163
1150;63;2012;93;0;69;808;7260;3066;2.367906067;24;-119;3529;13.12;463;8068
1151;63;2013;83;0;76;1056;7185;3035;2.36738056;7;166;3529;14;494;8241
1152;63;2014;94;24;80;782;7229;3054;2.367059594;14;-244;3552;14.02;498;8011
1153;63;2015;116;2;75;1009;7198;3041;2.366984545;41;155;3554;14.43;513;8207
1154;63;2016;94;0;79;490;7150;3021;2.366765972;15;-582;3554;15;533;7640
1155;63;2017;87;0;72;74;7088;2993;2.368192449;15;-493;3554;15.79;561;7162
1156;63;2018;79;3;77;74;7087;2993;2.367858336;2;-3;3557;15.86;564;7161
1157;65;1985;109;8;33;96;6693;2452;2.729609;76;-455;3833;36.03;1381;6789
1158;65;1986;94;7;35;92;6358;2362;2.691787;59;-398;3811;38.02;1449;6450
1159;65;1987;89;10;32;87;5958;2239;2.661009;57;-462;3788;40.89;1549;6045
1160;65;1988;82;9;33;83;5667;2153;2.632141;49;-344;3803;43.39;1650;5750
1161;65;1989;93;3;31;85;5811;2236;2.598837;62;84;3768;40.66;1532;5896
1162;65;1990;90;3;36;24;6011;2382;2.52351;54;85;3527;32.46;1145;6035
1163;65;1991;103;8;32;20;6121;2430;2.51893;71;35;3530;31.16;1100;6141
1164;65;1992;116;16;31;18;6191;2501;2.47541;85;-17;3538;29.31;1037;6209
1165;65;1993;103;9;26;18;6253;2550;2.452157;77;-15;3554;28.25;1004;6271
1166;65;1994;78;22;25;38;6342;2595;2.443931;53;56;3563;27.17;968;6380
1167;65;1995;100;32;38;33;7110;2768;2.568642;62;701;3772;26.62;1004;7143
1168;65;1996;128;43;41;42;7512;3126;2.403071;87;324;3804;17.82;678;7554
1169;65;1997;96;58;33;67;7793;3290;2.368693;63;243;3847;14.48;557;7860
1170;65;1998;118;44;33;44;7791;3317;2.348809;85;-110;3905;15.06;588;7835
1171;65;1999;127;43;46;21;7801;3345;2.332138;81;-94;3949;15.3;604;7822
1172;65;2000;145;15;38;99;7841;3032;2.586081794;107;14;3974;23.7;942;7940
1173;65;2001;136;59;45;99;7722;2989;2.583472733;91;-210;4014;25.54;1025;7821
1174;65;2002;131;54;38;99;7627;2957;2.579303348;93;-188;4050;26.99;1093;7726
1175;65;2003;118;93;36;99;7421;2884;2.573162275;82;-288;4125;30.08;1241;7520
1176;65;2004;116;60;37;99;7317;2847;2.570073762;79;-183;4164;31.63;1317;7416
1177;65;2005;115;65;26;99;7185;2799;2.56698821;89;-221;4210;33.52;1411;7284
1178;65;2006;112;55;28;99;7118;2777;2.563197695;84;-151;4243;34.55;1466;7217
1179;65;2007;119;52;53;99;7172;2803;2.558687121;66;-12;4273;34.4;1470;7271
1180;65;2008;128;52;45;99;7170;2806;2.555238774;83;-85;4304;34.8;1498;7269
1181;65;2009;120;25;37;99;7075;2775;2.54954955;83;-178;4285;35.24;1510;7174
1182;65;2010;106;0;36;133;7149;2941;2.430805848;70;38;4271;31.14;1330;7282
1183;65;2011;104;20;41;67;7222;2972;2.430013459;63;-56;4272;30.43;1300;7289
1184;65;2012;72;18;40;67;7136;2937;2.42969016;32;-118;4277;31.33;1340;7203
1185;65;2013;80;20;35;67;7153;2944;2.4296875;45;-28;4277;31.17;1333;7220
1186;65;2014;80;0;43;75;7202;2964;2.429824561;37;20;4277;30.7;1313;7277
1187;65;2015;86;0;42;91;7308;3008;2.429521277;44;78;4277;29.67;1269;7399
1188;65;2016;64;39;44;82;7446;3066;2.428571429;20;109;4294;28.6;1228;7528
1189;65;2017;86;32;38;82;7612;3136;2.427295918;48;118;4314;27.31;1178;7694
1190;65;2018;84;24;36;82;7682;3166;2.426405559;48;22;4318;26.68;1152;7764
1191;67;1985;550;304;182;1243;30150;11329;2.661312;368;-47;14935;24.14;3606;31393
1192;67;1986;460;194;204;1203;29587;11137;2.65664;256;-859;15223;26.84;4086;30790
1193;67;1987;486;139;192;1201;29715;11213;2.650049;294;-168;15400;27.19;4187;30916
1194;67;1988;456;108;196;1350;29829;11279;2.644649;260;3;15565;27.54;4286;31179
1195;67;1989;427;198;198;1400;30409;11562;2.630081;229;401;15835;26.98;4273;31809
1196;67;1990;448;245;190;1666;30800;11976;2.57181;258;399;15412;22.29;3436;32466
1197;67;1991;423;264;204;1672;31739;12363;2.567257;219;726;15657;21.04;3294;33411
1198;67;1992;439;392;205;1716;32713;12743;2.567135;234;784;15921;19.96;3178;34429
1199;67;1993;417;467;202;1773;33825;13287;2.545721;215;954;16613;20.02;3326;35598
1200;67;1994;419;590;235;2022;34884;13767;2.533885;184;1124;17165;19.8;3398;36906
1201;67;1995;481;643;224;1856;36904;14316;2.577815;257;1597;17755;19.37;3439;38760
1202;67;1996;406;514;250;2053;37651;14979;2.513586;156;788;19237;22.13;4258;39704
1203;67;1997;469;465;253;2167;38151;15324;2.489624;216;398;19768;22.48;4444;40318
1204;67;1998;420;514;232;2141;39032;15716;2.483584;188;667;20233;22.32;4517;41173
1205;67;1999;425;401;249;2115;40642;15976;2.543941;176;1408;20747;23;4771;42757
1206;67;2000;437;105;241;1825;42753;17602;2.428871719;196;1625;21117;16.65;3515;44578
1207;67;2001;475;421;218;1828;43817;18067;2.425250457;257;810;21728;16.85;3661;45645
1208;67;2002;458;537;246;1841;44248;18288;2.419510061;212;232;22253;17.82;3965;46089
1209;67;2003;479;501;271;1841;44606;18475;2.414397835;208;150;22632;18.37;4157;46447
1210;67;2004;516;737;269;1831;45095;18728;2.407891927;247;232;23259;19.48;4531;46926
1211;67;2005;501;732;245;1839;45874;19094;2.402534828;256;531;23858;19.97;4764;47713
1212;67;2006;564;873;302;1832;46576;19423;2.397981774;262;433;24583;20.99;5160;48408
1213;67;2007;597;690;280;1838;47308;19758;2.3943719;317;421;25160;21.47;5402;49146
1214;67;2008;606;692;277;1928;48145;20154;2.38885581;329;598;25719;21.64;5565;50073
1215;67;2009;593;336;275;1910;48849;20488;2.384273721;318;368;25813;20.63;5325;50759
1216;67;2010;589;58.25;270;1715;49726;21144;2.351778282;319;363;25918;18.42;4774;51441
1217;67;2011;543;222;246;1713;50180;21334;2.352113996;297;155;26124;18.34;4790;51893
1218;67;2012;536;154;332;1876;50619;21519;2.352293322;204;398;26266;18.07;4747;52495
1219;67;2013;495;172;315;2097;51316;21814;2.352434217;180;738;26429;17.46;4615;53413
1220;67;2014;552;275;301;1979;51945;22082;2.352368445;251;260;26685;17.25;4603;53924
1221;67;2015;579;278;345;2026;52739;22424;2.35189975;234;607;26948;16.79;4524;54765
1222;67;2016;571;336;351;1975;53457;22738;2.350998329;220;447;27268;16.61;4530;55432
1223;67;2017;503;260;353;1898;53775;22872;2.351128017;150;91;27515;16.87;4643;55673
1224;67;2018;459;564;338;1896;54506;23197;2.349700392;121;608;28070;17.36;4873;56402
1225;69;1985;2785;2619;962;8066;162658;63873;2.546585;1823;2437;72762;12.22;8889;170724
1226;69;1986;2784;1937;1085;8337;166643;65821;2.53176;1699;2557;75415;12.72;9594;174980
1227;69;1987;2660;1536;1015;8517;169634;67423;2.515966;1645;1526;77385;12.87;9962;178151
1228;69;1988;2773;1277;992;8275;171945;68770;2.500291;1781;288;78981;12.93;10211;180220
1229;69;1989;2665;1063;1042;8572;175026;70505;2.482462;1623;1755;80242;12.13;9737;183598
1230;69;1990;2769;1210;1024;6524;180557;70472;2.56211;1745;1738;77811;9.43;7339;187081
1231;69;1991;2699;1517;1090;6799;186743;72906;2.561422;1609;4852;79021;7.74;6115;193542
1232;69;1992;2785;1905;1169;7077;192589;75342;2.556197;1616;4508;80538;6.45;5196;199666
1233;69;1993;2643;2610;1132;7141;199703;77339;2.582177;1511;5667;82443;6.19;5104;206844
1234;69;1994;2793;3170;1144;7387;207549;79859;2.598943;1649;6443;85053;6.11;5194;214936
1235;69;1995;2779;2797;1262;7640;213982;82061;2.607597;1517;5169;88223;6.98;6162;221622
1236;69;1996;2821;3491;1246;7998;219250;83997;2.610212;1575;4051;91020;7.72;7023;227248
1237;69;1997;2784;2776;1302;8353;224443;86334;2.599706;1482;4066;94645;8.78;8311;232796
1238;69;1998;2843;3222;1332;8066;231014;88543;2.60906;1511;4773;97421;9.11;8878;239080
1239;69;1999;2993;3591;1432;7779;238377;91039;2.618405;1561;5515;100714;9.61;9675;246156
1240;69;2000;3228;866;1431;7120;245968;97905;2.512312956;1797;5133;106267;7.87;8362;253088
1241;69;2001;3311;3464;1523;7120;253791;101432;2.502080211;1788;6035;109883;7.69;8451;260911
1242;69;2002;3289;3628;1516;7120;259051;103935;2.49243277;1773;3487;113808;8.68;9873;266171
1243;69;2003;3358;3052;1531;7120;261026;105158;2.482226745;1827;148;117039;10.15;11881;268146
1244;69;2004;3500;3030;1551;7770;265499;107379;2.472541186;1949;3174;120291;10.73;12912;273269
1245;69;2005;3318;3290;1530;7770;268103;108816;2.463819659;1788;816;123765;12.08;14949;275873
1246;69;2006;3511;2907;1540;7770;273257;111307;2.454984862;1971;3183;126495;12.01;15188;281027
1247;69;2007;3517;2221;1532;7787;278967;114060;2.445791689;1985;3742;128796;11.44;14736;286754
1248;69;2008;3425;1331;1687;7812;284582;116799;2.436510587;1738;3902;130534;10.52;13735;292394
1249;69;2009;3566;1254;1664;7812;289690;119363;2.42696648;1902;3206;132197;9.71;12834;297502
1250;69;2010;3378;120.15;1818;8530;292002;120676;2.419718917;1560;1470;133124;9.35;12448;300532
1251;69;2011;3313;1273.89;1861;8376;296946;122699;2.420117523;1452;3338;134560;8.81;11861;305322
1252;69;2012;3407;1338.83;1871;8447;302502;124969;2.420616313;1536;4091;136076;8.16;11107;310949
1253;69;2013;3375;2170;1990;8623;307735;127081;2.421565773;1385;4024;138206;8.05;11125;316358
1254;69;2014;3490;2711;1986;8938;315219;130100;2.422897771;1504;6295;140877;7.65;10777;324157
1255;69;2015;3448;2665.68;2246;9373;324056;133678;2.424153563;1202;8070;143650;6.94;9972;333429
1256;69;2016;3463;2588.02;2182;9323;329740;135948;2.425486215;1281;4353;146095;6.95;10147;339063
1257;69;2017;3346;3628.87;2407;9375;334675;137872;2.427432691;939;4048;149026;7.48;11154;344050
1258;69;2018;3284;3092.87;2396;9410;340952;140370;2.428952055;888;5424;152217;7.78;11847;350362
1259;71;1985;185;22;163;469;13772;5313;2.592133;22;-496;6645;20.05;1332;14241
1260;71;1986;183;19;191;462;13651;5312;2.569842;-8;-120;6727;21.03;1415;14113
1261;71;1987;191;21;197;472;13925;5456;2.552236;-6;290;6806;19.84;1350;14397
1262;71;1988;183;19;162;385;13837;5459;2.534713;21;-196;6833;20.11;1374;14222
1263;71;1989;155;26;161;356;13604;5410;2.514603;-6;-256;6838;20.88;1428;13960
1264;71;1990;208;36;182;382;13390;5421;2.470024;26;-214;6975;22.28;1554;13772
1265;71;1991;193;55;196;394;13422;5467;2.455094;-3;47;7011;22.02;1544;13816
1266;71;1992;197;38;149;374;13655;5393;2.531986;48;165;7066;23.68;1673;14029
1267;71;1993;152;39;157;389;13823;5728;2.413233;-5;188;7104;19.37;1376;14212
1268;71;1994;176;59;173;432;14322;5953;2.405846;3;539;7143;16.66;1190;14754
1269;71;1995;169;108;210;394;14515;6081;2.386943;-41;196;7202;15.57;1121;14909
1270;71;1996;156;83;179;404;14563;6171;2.359909;-23;81;7314;15.63;1143;14967
1271;71;1997;146;85;181;409;14636;6286;2.328349;-35;113;7397;15.02;1111;15045
1272;71;1998;163;87;151;377;14677;6345;2.31316;12;-3;7482;15.2;1137;15054
1273;71;1999;161;89;183;345;14797;6441;2.297314;-22;110;7569;14.9;1128;15142
1274;71;2000;193;20;162;391;14895;6212;2.397778493;31;117;7647;18.77;1435;15286
1275;71;2001;165;81;209;391;14919;6249;2.387421988;-44;68;7721;19.06;1472;15310
1276;71;2002;172;76;184;578;15081;6344;2.37720681;-12;361;7790;18.56;1446;15659
1277;71;2003;168;104;162;870;15219;6432;2.36613806;6;424;7887;18.45;1455;16089
1278;71;2004;176;72;186;868;14832;6295;2.356155679;-10;-379;7953;20.85;1658;15700
1279;71;2005;177;45;165;870;14700;6267;2.345619914;12;-142;7991;21.57;1724;15570
1280;71;2006;189;54;171;873;14679;6287;2.334817878;18;-36;8037;21.77;1750;15552
1281;71;2007;177;47;152;862;14663;6310;2.323771791;25;-52;8080;21.91;1770;15525
1282;71;2008;190;60;176;866;14620;6321;2.31292517;14;-53;8161;22.55;1840;15486
1283;71;2009;193;32;165;862;14615;6348;2.302299937;28;-37;8204;22.62;1856;15477
1284;71;2010;154;4.5;176;858;14549;6340;2.294794953;-22;-48;8221;22.88;1881;15407
1285;71;2011;149;66.05;196;861;14179;6179;2.294707882;-47;-320;8285;25.42;2106;15040
1286;71;2012;149;79.94;163;783;14179;6181;2.293965378;-14;-64;8362;26.08;2181;14962
1287;71;2013;147;129.83;185;786;13585;5921;2.29437595;-38;-553;8488;30.24;2567;14371
1288;71;2014;119;39.65;159;879;13176;5744;2.293871866;-40;-276;8526;32.63;2782;14055
1289;71;2015;125;5.97;181;884;13168;5741;2.29367706;-56;53;8532;32.71;2791;14052
1290;71;2016;130;3;184;883;13193;5751;2.29403582;-54;78;8535;32.62;2784;14076
1291;71;2017;145;4;182;882;13328;5846;2.27984947;-37;171;8542;31.56;2696;14210
1292;71;2018;102;17;161;918;13568;5914;2.294217112;-59;335;8563;30.94;2649;14486
1293;73;1985;76;6;51;107;4481;1872;2.393697;25;92;2296;18.47;424;4588
1294;73;1986;80;2;47;103;4328;1829;2.36632;33;-190;2265;19.25;436;4431
1295;73;1987;67;1;51;104;4338;1850;2.344865;16;-5;2231;17.08;381;4442
1296;73;1988;81;4;62;107;4470;1923;2.324493;19;116;2235;13.96;312;4577
1297;73;1989;56;6;47;108;4441;1933;2.297465;9;-37;2397;19.36;464;4549
1298;73;1990;60;-50;53;105;4609;1817;2.536599;7;158;2204;17.56;387;4714
1299;73;1991;61;40;65;585;4845;1892;2.560782;-4;720;2226;15;334;5430
1300;73;1992;51;1;60;1035;4940;1930;2.559586;-9;554;2266;14.83;336;5975
1301;73;1993;56;23;58;1074;4804;2051;2.342272;-2;-95;2267;9.53;216;5878
1302;73;1994;59;1;52;1085;4854;2087;2.325827;7;54;2290;8.86;203;5939
1303;73;1995;54;6;60;991;4992;2169;2.301522;-6;50;2291;5.33;122;5983
1304;73;1996;61;16;67;1973;4139;1884;2.196921;-6;135;2297;17.98;413;6112
1305;73;1997;56;16;60;1074;5020;2260;2.221239;-4;-14;2313;2.29;53;6094
1306;73;1998;61;18;55;1068;5039;2280;2.210088;6;7;2329;2.1;49;6107
1307;73;1999;52;13;65;1062;5034;2299;2.189648;-13;2;2347;2.05;48;6096
1308;73;2000;54;3;50;1056;5107;2101;2.430747263;4;71;2403;12.57;302;6163
1309;73;2001;52;13;61;1044;5032;2079;2.42039442;-9;-78;2412;13.81;333;6076
1310;73;2002;59;7;63;1046;5001;2074;2.411282546;-4;-25;2413;14.05;339;6047
1311;73;2003;62;8;60;1046;5006;2085;2.400959233;2;3;2416;13.7;331;6052
1312;73;2004;63;5;46;1059;4848;2027;2.391711889;17;-162;2416;16.1;389;5907
1313;73;2005;46;5;49;1072;4715;1980;2.381313131;-3;-117;2416;18.05;436;5787
1314;73;2006;80;6;51;1077;4588;1933;2.373512675;29;-151;2416;19.99;483;5665
1315;73;2007;61;9;56;1073;4498;1902;2.364879075;5;-99;2420;21.4;518;5571
1316;73;2008;51;2;55;1075;4447;1888;2.355402542;-4;-45;2417;21.89;529;5522
1317;73;2009;61;1;50;1088;4375;1865;2.345844504;11;-70;2420;22.93;555;5463
1318;73;2010;57;1.75;48;1030;4444;1950;2.278974359;9;2;2422;19.49;472;5474
1319;73;2011;64;1;52;971;4416;1940;2.27628866;12;-99;2423;19.93;483;5387
1320;73;2012;50;4;56;1027;4415;1940;2.275773196;-6;61;2426;20.03;486;5442
1321;73;2013;72;9;41;1014;4410;1936;2.277892562;31;-49;2437;20.56;501;5424
1322;73;2014;49;7.81;47;1032;4479;1965;2.279389313;2;85;2444;19.6;479;5511
1323;73;2015;69;2;66;1022;4525;1985;2.279596977;3;33;2446;18.85;461;5547
1324;73;2016;52;15;59;959;4589;2013;2.279682067;-7;8;2461;18.2;448;5548
1325;73;2017;53;10;53;953;4567;2004;2.278942116;0;-28;2470;18.87;466;5520
1326;73;2018;59;11;56;1001;4579;2009;2.279243405;3;57;2481;19.02;472;5580
1327;75;1985;288;12;163;624;18439;7377;2.499526;125;-455;8381;11.98;1004;19063
1328;75;1986;264;8;154;598;17569;7144;2.459266;110;-1006;8389;14.84;1245;18167
1329;75;1987;257;2;170;590;17150;7072;2.425056;87;-514;8393;15.74;1321;17740
1330;75;1988;232;-7;181;500;17432;7292;2.390565;51;141;8404;13.23;1112;17932
1331;75;1989;243;13;162;437;17288;7342;2.354672;81;-288;8340;11.97;998;17725
1332;75;1990;235;4;197;387;17100;6978;2.450559;38;-276;7824;10.81;846;17487
1333;75;1991;234;10;179;379;17124;7143;2.397312;55;-39;7828;8.75;685;17503
1334;75;1992;242;5;186;361;17201;7218;2.38307;56;3;7838;7.91;620;17562
1335;75;1993;262;8;162;418;17541;6928;2.531899;100;297;7843;11.67;915;17959
1336;75;1994;238;36;136;421;18407;7194;2.55866;102;767;7851;8.37;657;18828
1337;75;1995;244;85;177;470;18898;7319;2.582047;67;473;7887;7.2;568;19368
1338;75;1996;244;101;174;538;19123;7366;2.596117;70;223;7972;7.6;606;19661
1339;75;1997;236;108;195;619;19389;7458;2.599759;41;306;8073;7.62;615;20008
1340;75;1998;258;137;178;678;19325;7366;2.623541;80;-85;8181;9.96;815;20003
1341;75;1999;256;55;183;737;19552;7389;2.646096;73;213;8318;11.17;929;20289
1342;75;2000;246;18;194;1988;18667;7621;2.449416087;52;309;8473;10.06;852;20655
1343;75;2001;270;71;206;2322;20032;8218;2.437576053;64;1635;8531;3.67;313;22354
1344;75;2002;250;61;204;2263;19832;8173;2.426526367;46;-305;8608;5.05;435;22095
1345;75;2003;298;37;193;2369;20002;8273;2.41774447;105;171;8723;5.16;450;22371
1346;75;2004;239;53;210;2324;19857;8252;2.406325739;29;-219;8805;6.28;553;22181
1347;75;2005;223;45;202;2336;19752;8251;2.393891649;21;-114;8854;6.81;603;22088
1348;75;2006;230;54;199;2329;19938;8369;2.382363484;31;148;8878;5.73;509;22267
1349;75;2007;244;40;180;2454;19949;8416;2.37036597;64;72;8919;5.64;503;22403
1350;75;2008;231;19;207;2419;19905;8442;2.357853589;24;-103;8962;5.8;520;22324
1351;75;2009;253;11;194;2455;20062;8552;2.345884004;59;134;8990;4.87;438;22517
1352;75;2010;206;3.75;202;3474;18819;8052;2.337183308;4;-228;8985;10.38;933;22293
1353;75;2011;212;15;182;3418;18695;7998;2.337459365;30;-210;9000;11.13;1002;22113
1354;75;2012;223;13;182;3253;18644;7978;2.336926548;41;-257;9013;11.48;1035;21897
1355;75;2013;252;10;199;3196;18511;7920;2.337247475;53;-243;9023;12.22;1103;21707
1356;75;2014;240;21;239;3366;18619;7965;2.337602009;1;277;9044;11.93;1079;21985
1357;75;2015;219;20;185;3326;18689;7994;2.337878409;34;-4;9064;11.8;1070;22015
1358;75;2016;223;27;257;3375;18592;7950;2.338616352;-34;-14;9090;12.54;1140;21967
1359;75;2017;237;14;228;3365;18524;7923;2.338003282;9;-87;9104;12.97;1181;21889
1360;75;2018;235;11;196;3400;18456;7893;2.33827442;39;-72;9112;13.38;1219;21856
1361;77;1985;1423;147;682;2112;85909;33295;2.580237;741;-6237;40995;18.78;7700;88021
1362;77;1986;1343;62;717;2057;83505;32661;2.556719;626;-3085;41667;21.61;9006;85562
1363;77;1987;1176;97;751;2062;83497;32895;2.538289;425;-428;42254;22.15;9359;85559
1364;77;1988;1209;169;848;1971;85317;33859;2.519773;361;1368;42417;20.18;8558;87288
1365;77;1989;1246;228;819;2163;88430;35433;2.495696;427;2878;40772;13.09;5339;90593
1366;77;1990;1281;267;818;2348;91229;36250;2.516662;463;2521;39208;7.54;2958;93577
1367;77;1991;1273;343;858;2359;93633;37531;2.494818;415;2000;39475;4.92;1944;95992
1368;77;1992;1292;563;846;2415;94996;38392;2.47437;446;973;39818;3.58;1426;97411
1369;77;1993;1344;791;864;2523;97380;39151;2.487293;480;2012;40381;3.05;1230;99903
1370;77;1994;1292;924;962;2505;100262;39552;2.534941;330;2534;41172;3.93;1620;102767
1371;77;1995;1304;941;920;2761;102645;40691;2.522548;384;2255;42096;3.34;1405;105406
1372;77;1996;1342;1044;1000;2806;104723;41627;2.515747;342;1781;43037;3.28;1410;107529
1373;77;1997;1363;1114;1022;2862;106900;42915;2.490971;341;1892;44081;2.65;1166;109762
1374;77;1998;1404;1286;1078;2977;109350;43781;2.497659;326;2239;45195;3.13;1414;112327
1375;77;1999;1428;1362;1012;2881;111692;44717;2.497752;416;1830;50976;12.28;6259;114573
1376;77;2000;1485;320;1109;3296;114355;46384;2.465397551;376;2705;49075;5.48;2691;117651
1377;77;2001;1507;1279;1184;3296;116568;47289;2.465013005;323;1890;50299;5.98;3010;119864
1378;77;2002;1522;1219;1161;3296;118491;48078;2.464557594;361;1562;51456;6.56;3378;121787
1379;77;2003;1554;1330;1231;3296;120856;49062;2.46333211;323;2042;52889;7.24;3827;124152
1380;77;2004;1708;1548;1200;3296;123330;50104;2.461480121;508;1966;54221;7.59;4117;126626
1381;77;2005;1755;1511;1232;3296;125703;51099;2.459989432;523;1850;56346;9.31;5247;128999
1382;77;2006;1859;1449;1270;3584;129544;52649;2.460521567;589;3540;58239;9.6;5590;133128
1383;77;2007;1994;1494;1210;3584;133806;54381;2.460528493;784;3478;60151;9.59;5770;137390
1384;77;2008;2062;1296;1353;3627;137053;55703;2.460424035;709;2581;61775;9.83;6072;140680
1385;77;2009;2048;753;1292;3903;140892;57258;2.460651787;756;3359;62440;8.3;5182;144795
1386;77;2010;2021;91.25;1309;4467;142688;57985;2.460774338;712;1648;62988;7.94;5003;147155
1387;77;2011;1908;471.83;1296;4628;143309;58239;2.460705026;612;170;63446;8.21;5207;147937
1388;77;2012;1818;406.24;1306;4642;143292;58235;2.460582124;512;-515;63835;8.77;5600;147934
1389;77;2013;1854;552;1378;4950;142936;58092;2.460510914;476;-524;64357;9.73;6265;147886
1390;77;2014;1760;503;1382;4631;143164;58187;2.46041212;378;-469;64836;10.26;6649;147795
1391;77;2015;1826;630;1492;4983;143674;58400;2.460171233;334;528;65440;10.76;7040;148657
1392;77;2016;1709;476;1477;5150;145146;59002;2.460018304;232;1407;65902;10.47;6900;150296
1393;77;2017;1656;639.07;1518;5144;146777;59679;2.459441345;138;1487;66512;10.27;6833;151921
1394;77;2018;1657;755;1527;5140;148489;60387;2.458956398;130;1578;67458;10.48;7071;153629
1395;79;1985;16;10;4;0;836;323;2.588235;12;-40;887;63.59;564;836
1396;79;1986;12;12;5;0;771;298;2.587248;7;-72;877;66.02;579;771
1397;79;1987;14;7;0;0;738;285;2.589474;13;-47;868;67.17;583;738
1398;79;1988;7;3;6;0;689;265;2.6;1;-50;876;69.75;611;689
1399;79;1989;9;9;4;0;611;235;2.6;5;-83;923;74.54;688;611
1400;79;1990;5;10;6;0;558;247;2.259109;-1;-52;1201;79.43;954;558
1401;79;1991;6;11;8;0;570;238;2.394958;-2;14;1211;80.35;973;570
1402;79;1992;8;15;0;0;590;240;2.458333;8;12;1222;80.36;982;590
1403;79;1993;8;16;4;0;600;253;2.371542;4;6;1237;79.55;984;600
1404;79;1994;8;16;8;0;646;269;2.401487;0;46;1253;78.53;984;646
1405;79;1995;7;25;4;0;674;277;2.433213;3;25;1269;78.17;992;674
1406;79;1996;8;31;7;0;724;294;2.462585;1;49;1294;77.28;1000;724
1407;79;1997;6;12;4;0;744;301;2.471761;2;18;1325;77.28;1024;744
1408;79;1998;3;14;6;0;772;308;2.506494;-3;31;1337;76.96;1029;772
1409;79;1999;3;13;3;0;806;317;2.542587;0;34;1351;76.54;1034;806
1410;79;2000;5;3;9;1;836;381;2.194225722;-4;34;1120;65.98;739;837
1411;79;2001;5;14;5;1;819;376;2.178191489;0;-17;1126;66.61;750;820
1412;79;2002;5;15;7;1;804;373;2.155495979;-2;-13;1135;67.14;762;805
1413;79;2003;6;16;4;1;829;387;2.142118863;2;23;1143;66.14;756;830
1414;79;2004;9;17;5;1;841;398;2.113065327;4;8;1152;65.45;754;842
1415;79;2005;2;19;5;1;805;383;2.101827676;-3;-33;1163;67.07;780;806
1416;79;2006;1;24;7;1;788;379;2.079155673;-6;-11;1178;67.83;799;789
1417;79;2007;5;23;5;1;802;389;2.061696658;0;14;1192;67.37;803;803
1418;79;2008;2;20;7;1;766;376;2.037234043;-5;-31;1203;68.74;827;767
1419;79;2009;5;4;5;1;713;353;2.019830028;0;-53;1202;70.63;849;714
1420;79;2010;9;1.75;8;0;705;351;2.008547009;1;-10;1203;70.82;852;705
1421;79;2011;5;5;3;0;712;354;2.011299435;2;5;1208;70.7;854;712
1422;79;2012;6;9;5;0;720;359;2.005571031;1;7;1217;70.5;858;720
1423;79;2013;4;8;4;0;733;366;2.00273224;0;13;1225;70.12;859;733
1424;79;2014;5;11;4;0;703;350;2.008571429;1;-31;1236;71.68;886;703
1425;79;2015;6;6;7;0;746;372;2.005376344;-1;44;1242;70.05;870;746
1426;79;2016;8;12;6;0;758;378;2.005291005;2;10;1254;69.86;876;758
1427;79;2017;7;14;16;0;754;376;2.005319149;-9;5;1268;70.35;892;754
1428;79;2018;8;19;4;0;775;387;2.002583979;4;17;1287;69.93;900;775
1429;81;1985;256;3;63;97;13189;4567;2.887891;193;-1305;5772;20.88;1205;13286
1430;81;1986;193;0;60;92;12587;4351;2.892898;133;-740;5740;24.2;1389;12679
1431;81;1987;184;7;63;85;11801;4065;2.903075;121;-914;5706;28.76;1641;11886
1432;81;1988;152;-6;81;83;11671;4005;2.914107;71;-203;5727;30.07;1722;11754
1433;81;1989;175;-12;55;82;11444;3921;2.918643;120;-348;5498;28.68;1577;11526
1434;81;1990;161;2;56;129;11225;4178;2.686692;105;-277;5235;20.19;1057;11354
1435;81;1991;176;2;67;133;11316;4327;2.615207;109;-14;5237;17.38;910;11449
1436;81;1992;138;7;85;133;11559;4319;2.676314;53;190;5239;17.56;920;11692
1437;81;1993;154;15;70;133;11664;4318;2.701251;84;21;5246;17.69;928;11797
1438;81;1994;135;17;53;135;11861;4373;2.712326;82;117;5261;16.88;888;11996
1439;81;1995;131;44;100;136;12051;4442;2.712967;31;160;5278;15.84;836;12187
1440;81;1996;141;42;66;137;12154;4484;2.710526;75;29;5371;16.51;887;12291
1441;81;1997;158;60;90;139;12433;4617;2.692874;68;213;5413;14.71;796;12572
1442;81;1998;168;34;71;139;12673;4700;2.696383;97;143;5473;14.12;773;12812
1443;81;1999;166;44;73;139;12886;4773;2.699769;93;120;5507;13.33;734;13025
1444;81;2000;180;10;97;311;12871;4987;2.580910367;83;73;5645;11.66;658;13182
1445;81;2001;201;40;100;311;12778;4965;2.573615307;101;-194;5712;13.08;747;13089
1446;81;2002;209;43;106;311;12823;4996;2.566653323;103;-58;5760;13.26;764;13134
1447;81;2003;175;59;102;311;12743;4980;2.558835341;73;-153;5850;14.87;870;13054
1448;81;2004;205;60;85;311;12752;4999;2.550910182;120;-111;5909;15.4;910;13063
1449;81;2005;172;69;91;311;12654;4976;2.543006431;81;-179;5978;16.76;1002;12965
1450;81;2006;204;73;91;311;12791;5045;2.535381566;113;24;6050;16.61;1005;13102
1451;81;2007;215;49;108;311;12959;5126;2.52809208;107;61;6098;15.94;972;13270
1452;81;2008;224;63;88;311;13135;5212;2.520145817;136;40;6160;15.39;948;13446
1453;81;2009;224;39;80;311;13233;5269;2.511482255;144;-46;6181;14.75;912;13544
1454;81;2010;217;5.25;103;102;13704;5470;2.505301645;114;148;6202;11.8;732;13806
1455;81;2011;187;7;67;102;13333;5321;2.505732005;120;-491;6209;14.3;888;13435
1456;81;2012;164;10;120;102;13081;5221;2.505458724;44;-296;6219;16.05;998;13183
1457;81;2013;190;11;91;102;13036;5203;2.505477609;99;-144;6230;16.48;1027;13138
1458;81;2014;176;9;90;102;12849;5127;2.506143944;86;-273;6239;17.82;1112;12951
1459;81;2015;193;9;98;102;12852;5129;2.505751609;95;-92;6248;17.91;1119;12954
1460;81;2016;181;7;91;102;13064;5213;2.506042586;90;122;6255;16.66;1042;13166
1461;81;2017;178;10;103;102;13006;5451;2.385984223;75;-133;6265;12.99;814;13108
1462;81;2018;155;11;99;102;13076;5468;2.391367959;56;14;6276;12.87;808;13178
1463;83;1985;345;18;109;160;19123;6390;2.992645;236;-784;7601;15.93;1211;19283
1464;83;1986;310;15;149;154;18681;6209;3.008697;161;-609;7740;19.78;1531;18835
1465;83;1987;319;6;144;148;18044;5960;3.027517;175;-818;7877;24.34;1917;18192
1466;83;1988;321;12;149;145;17965;5897;3.046464;172;-254;7904;25.39;2007;18110
1467;83;1989;316;4;163;146;18286;5973;3.061443;153;169;7675;22.18;1702;18432
1468;83;1990;278;9;159;152;18558;6762;2.744454;119;159;8050;16;1288;18710
1469;83;1991;259;18;165;150;18910;6711;2.817762;94;256;8059;16.73;1348;19060
1470;83;1992;320;23;139;155;19496;6939;2.809627;181;410;8077;14.09;1138;19651
1471;83;1993;325;79;164;168;20472;7426;2.7568;161;828;8482;12.45;1056;20640
1472;83;1994;302;56;186;172;21221;7652;2.773262;116;637;8767;12.72;1115;21393
1473;83;1995;316;57;175;171;21988;7914;2.778368;141;625;8856;10.64;942;22159
1474;83;1996;341;70;205;175;22475;8090;2.778121;136;355;9125;11.34;1035;22650
1475;83;1997;296;27;192;175;22798;8251;2.763059;104;219;9339;11.65;1088;22973
1476;83;1998;295;61;204;175;22942;8290;2.767431;91;53;9366;11.49;1076;23117
1477;83;1999;315;23;227;175;23349;8426;2.771066;88;319;9427;10.62;1001;23524
1478;83;2000;309;10;234;438;23414;9224;2.538378144;75;259;10535;12.44;1311;23852
1479;83;2001;305;40;242;438;23435;9283;2.524507164;63;-42;10687;13.14;1404;23873
1480;83;2002;330;59;278;438;23671;9429;2.510446495;52;184;10861;13.18;1432;24109
1481;83;2003;309;38;236;438;23940;9590;2.496350365;73;196;11014;12.93;1424;24378
1482;83;2004;316;26;231;438;24169;9738;2.481926474;85;144;11162;12.76;1424;24607
1483;83;2005;306;41;260;438;24165;9792;2.467830882;46;-50;11323;13.52;1531;24603
1484;83;2006;298;59;245;438;24579;10020;2.452994012;53;361;11507;12.92;1487;25017
1485;83;2007;348;62;236;438;24739;10144;2.438781546;112;48;11691;13.23;1547;25177
1486;83;2008;324;42;259;438;24762;10214;2.424319561;65;-42;11861;13.89;1647;25200
1487;83;2009;320;19;256;438;24927;10343;2.410035773;64;101;11994;13.77;1651;25365
1488;83;2010;317;4;270;237;25295;10540;2.399905123;47;120;12098;12.88;1558;25532
1489;83;2011;308;11;288;237;25194;10499;2.39965711;20;-121;12109;13.3;1610;25431
1490;83;2012;294;8;268;237;25200;10501;2.39977145;26;-20;12117;13.34;1616;25437
1491;83;2013;293;9;252;237;25269;10529;2.399943015;41;28;12126;13.17;1597;25506
1492;83;2014;325;6;272;237;25239;10518;2.399600685;53;-83;12132;13.3;1614;25476
1493;83;2015;329;54;241;237;25459;10609;2.399754925;88;132;12186;12.94;1577;25696
1494;83;2016;297;32;262;237;25751;10732;2.39945956;35;257;12218;12.16;1486;25988
1495;83;2017;251;23;281;237;25871;10781;2.39968463;-30;150;12245;11.96;1464;26108
1496;83;2018;285;23;267;237;25918;10803;2.399148385;18;29;12277;12.01;1474;26155
1497;85;1985;348;108;238;441;23948;9155;2.615838;110;-692;10891;15.94;1736;24389
1498;85;1986;300;83;200;436;23397;9097;2.571947;100;-656;11040;17.6;1943;23833
1499;85;1987;276;62;228;443;23379;9235;2.531565;48;-59;11163;17.27;1928;23822
1500;85;1988;299;90;222;451;23636;9483;2.49246;77;188;11251;15.71;1768;24087
1501;85;1989;286;81;238;460;23821;9721;2.450468;48;146;11340;14.28;1619;24281
1502;85;1990;342;104;227;395;24144;9405;2.567145;115;143;10353;9.16;948;24539
1503;85;1991;319;127;244;412;24863;9833;2.528526;75;661;10457;5.97;624;25275
1504;85;1992;318;182;254;432;25791;10240;2.518652;64;884;10584;3.25;344;26223
1505;85;1993;362;257;254;446;26841;10426;2.574429;108;956;10766;3.16;340;27287
1506;85;1994;390;364;250;455;28047;10680;2.626124;140;1075;11023;3.11;343;28502
1507;85;1995;423;258;264;491;29179;11115;2.625191;159;1009;11387;2.39;272;29670
1508;85;1996;434;224;278;517;29970;11446;2.618382;156;661;11645;1.71;199;30487
1509;85;1997;481;213;293;530;30722;11783;2.607316;188;577;11869;0.72;86;31252
1510;85;1998;421;292;327;530;31307;11977;2.613927;94;491;12082;0.87;105;31837
1511;85;1999;438;320;302;530;32218;12242;2.631759;136;775;12393;1.22;151;32748
1512;85;2000;435;75;296;550;33027;13109;2.519414143;139;688;14292;8.28;1183;33577
1513;85;2001;469;300;314;550;33892;13474;2.515362921;155;710;14563;7.48;1089;34442
1514;85;2002;500;373;352;550;34376;13699;2.509380247;148;336;14924;8.21;1225;34926
1515;85;2003;449;295;345;550;35090;14020;2.502853067;104;610;15407;9;1387;35640
1516;85;2004;469;359;349;550;35581;14247;2.497438057;120;371;15783;9.73;1536;36131
1517;85;2005;515;486;309;550;36447;14622;2.49261387;206;660;16217;9.84;1595;36997
1518;85;2006;506;583;362;550;37418;15050;2.486245847;144;827;16877;10.83;1827;37968
1519;85;2007;504;536;364;550;38581;15550;2.481093248;140;1023;17478;11.03;1928;39131
1520;85;2008;563;369;404;550;39402;15908;2.476866985;159;662;17877;11.01;1969;39952
1521;85;2009;554;189;368;550;40130;16222;2.473801011;186;542;18083;10.29;1861;40680
1522;85;2010;487;29.5;389;542;40646;16451;2.470731263;98;410;18335;10.28;1884;41188
1523;85;2011;492;62;399;542;40427;16362;2.470785967;93;-312;18439;11.26;2077;40969
1524;85;2012;402;51;450;542;40118;16238;2.470624461;-48;-261;18529;12.36;2291;40660
1525;85;2013;455;51;383;542;40021;16197;2.470889671;72;-169;18618;13;2421;40563
1526;85;2014;481;72;388;542;40066;16216;2.47076961;93;-48;18708;13.32;2492;40608
1527;85;2015;454;89;459;542;40053;16210;2.470882171;-5;-8;18825;13.89;2615;40595
1528;85;2016;423;124;431;542;40635;16444;2.471114084;-8;590;18991;13.41;2547;41177
1529;85;2017;466;114;456;542;41260;16697;2.471102593;10;615;19182;12.95;2485;41802
1530;85;2018;449;210;427;542;41721;16879;2.471769655;22;439;19473;13.32;2594;42263
1531;87;1985;430;33;218;367;22064;8353;2.641446;212;-594;9588;12.88;1235;22431
1532;87;1986;370;79;223;354;21154;8105;2.609994;147;-1070;9622;15.77;1517;21508
1533;87;1987;349;9;230;360;21318;8249;2.584313;119;51;9701;14.97;1452;21678
1534;87;1988;371;8;233;362;21469;8386;2.5601;138;15;9722;13.74;1336;21831
1535;87;1989;386;5;202;360;21535;8492;2.535916;184;-120;9975;14.87;1483;21895
1536;87;1990;342;9;219;456;21600;8139;2.653889;123;38;9230;11.82;1091;22056
1537;87;1991;361;28;202;475;22228;8502;2.614444;159;488;9239;7.98;737;22703
1538;87;1992;392;55;246;495;22987;8812;2.608602;146;633;9267;4.91;455;23482
1539;87;1993;401;51;256;498;23743;8702;2.728453;145;614;9322;6.65;620;24241
1540;87;1994;448;191;239;518;24570;9139;2.688478;209;638;9373;2.5;234;25088
1541;87;1995;421;98;241;525;24837;9251;2.684791;180;94;9564;3.27;313;25362
1542;87;1996;451;104;214;542;25500;9516;2.679697;237;443;9690;1.8;174;26042
1543;87;1997;512;127;231;552;26095;9755;2.675038;281;324;9805;0.51;50;26647
1544;87;1998;465;186;238;552;26110;9765;2.673835;227;-212;9932;1.68;167;26662
1545;87;1999;540;108;225;552;26401;9877;2.672978;315;-24;10118;2.38;241;26953
1546;87;2000;465;28;232;484;26767;9578;2.794633535;233;64;10440;8.26;862;27251
1547;87;2001;475;113;276;484;26991;9696;2.783725248;199;25;10569;8.26;873;27475
1548;87;2002;482;94;251;484;27178;9806;2.771568427;231;-44;10679;8.17;873;27662
1549;87;2003;494;135;233;484;27371;9915;2.760564801;261;-68;10825;8.41;910;27855
1550;87;2004;414;122;226;479;27433;9979;2.749073053;188;-131;10964;8.98;985;27912
1551;87;2005;439;139;240;580;27367;9998;2.737247449;199;-164;11117;10.07;1119;27947
1552;87;2006;414;129;246;715;27268;10005;2.725437281;168;-132;11262;11.16;1257;27983
1553;87;2007;415;82;233;674;27174;10017;2.71278826;182;-317;11360;11.82;1343;27848
1554;87;2008;421;52;278;705;27041;10011;2.701128758;143;-245;11430;12.41;1419;27746
1555;87;2009;444;27;192;746;27280;10144;2.689274448;252;28;11463;11.51;1319;28026
1556;87;2010;447;4.75;239;564;27632;10307;2.680896478;208;-38;11494;10.33;1187;28196
1557;87;2011;460;2;277;564;27843;10386;2.680820335;183;28;11508;9.75;1122;28407
1558;87;2012;423;19;271;564;27643;10311;2.680923286;152;-352;11532;10.59;1221;28207
1559;87;2013;412;26;229;564;27623;10305;2.680543426;183;-203;11568;10.92;1263;28187
1560;87;2014;431;22;237;564;27510;10262;2.680763984;194;-307;11604;11.56;1342;28074
1561;87;2015;454;32;263;564;27627;10195;2.709857773;191;-74;11653;12.51;1458;28191
1562;87;2016;427;79;283;564;27522;10267;2.680627252;144;-249;11673;12.04;1406;28086
1563;87;2017;401;33;277;564;27580;10287;2.681053757;124;-66;11702;12.09;1415;28144
1564;87;2018;469;90;271;564;27940;10419;2.681639313;198;162;11789;11.62;1370;28504
1565;89;1985;348;6;255;517;21243;8064;2.634301;93;-172;9181;12.17;1117;21760
1566;89;1986;359;-10;212;514;20943;8042;2.604203;147;-450;9256;13.12;1214;21457
1567;89;1987;334;4;238;516;20398;7913;2.577783;96;-639;9312;15.02;1399;20914
1568;89;1988;322;11;237;445;20400;7995;2.551595;85;-154;9324;14.25;1329;20845
1569;89;1989;322;-2;218;454;20014;7932;2.523197;104;-481;9322;14.91;1390;20468
1570;89;1990;296;2;230;493;19717;7593;2.596734;66;-324;8739;13.11;1146;20210
1571;89;1991;287;9;223;502;19871;7523;2.641366;64;99;8741;13.93;1218;20373
1572;89;1992;318;18;250;546;19748;7820;2.52532;68;-147;8750;10.63;930;20294
1573;89;1993;346;3;238;543;19892;7768;2.560762;108;33;8768;11.41;1000;20435
1574;89;1994;299;4;248;535;19955;7816;2.553096;51;4;8771;10.89;955;20490
1575;89;1995;300;51;260;549;20146;7934;2.539198;40;165;8775;9.58;841;20695
1576;89;1996;271;29;252;611;20136;7984;2.522044;19;33;8826;9.54;842;20747
1577;89;1997;292;40;260;688;20079;8061;2.490882;32;-12;8855;8.97;794;20767
1578;89;1998;258;32;235;717;19799;7988;2.478593;23;-274;8895;10.2;907;20516
1579;89;1999;288;29;214;746;19653;7965;2.46742;74;-191;8927;10.78;962;20399
1580;89;2000;281;10;228;568;19675;7901;2.490191115;53;-218;8821;10.43;920;20243
1581;89;2001;298;41;217;568;19332;7798;2.479097204;81;-424;8852;11.91;1054;19900
1582;89;2002;322;35;247;568;19056;7723;2.467434935;75;-351;8875;12.98;1152;19624
1583;89;2003;296;21;227;568;19099;7776;2.456147119;69;-26;8886;12.49;1110;19667
1584;89;2004;291;44;216;568;18993;7768;2.445030896;75;-181;8920;12.91;1152;19561
1585;89;2005;300;21;245;568;18802;7724;2.434230968;55;-246;8931;13.51;1207;19370
1586;89;2006;232;13;223;568;18625;7688;2.42260666;9;-186;8933;13.94;1245;19193
1587;89;2007;255;21;216;568;18369;7617;2.411579362;39;-295;8945;14.85;1328;18937
1588;89;2008;280;37;265;568;18285;7619;2.39992125;15;-99;8971;15.07;1352;18853
1589;89;2009;230;6;229;568;18276;7650;2.389019608;1;-10;8973;14.74;1323;18844
1590;89;2010;218;0.75;213;433;18405;7732;2.380367305;5;-11;8970;13.8;1238;18838
1591;89;2011;245;3;216;433;18384;7724;2.380113931;29;-50;8973;13.92;1249;18817
1592;89;2012;270;3;258;433;18189;7637;2.381694383;12;-207;8976;14.92;1339;18622
1593;89;2013;188;4;220;433;18013;7567;2.380467821;-32;-144;8980;15.73;1413;18446
1594;89;2014;216;6;262;433;17900;7520;2.380319149;-46;-67;8986;16.31;1466;18333
1595;89;2015;193;2;240;433;17751;7457;2.380447901;-47;-102;8988;17.03;1531;18184
1596;89;2016;228;4;251;433;17768;7464;2.380493033;-23;40;8992;16.99;1528;18201
1597;89;2017;215;3;219;523;17839;7480;2.38012008;-4;165;8999;16.88;1519;18362
1598;89;2018;228;4;234;499;17866;7506;2.38022915;-6;9;9004;16.64;1498;18365
1599;91;1985;33;13;10;0;2130;776;2.744845;23;-89;1496;48.13;720;2130
1600;91;1986;20;29;16;0;1999;724;2.76105;4;-135;1508;51.99;784;1999
1601;91;1987;24;27;16;0;2151;776;2.771907;8;144;1536;49.48;760;2151
1602;91;1988;26;29;18;0;2219;777;2.855856;8;60;1565;50.35;788;2219
1603;91;1989;22;32;10;0;2262;810;2.792593;12;31;1613;49.78;803;2262
1604;91;1990;23;32;15;3;2312;947;2.441394;8;45;1507;37.16;560;2315
1605;91;1991;31;37;14;3;2416;1014;2.382643;17;87;1539;34.11;525;2419
1606;91;1992;29;66;25;3;2532;1101;2.299727;4;112;1576;30.14;475;2535
1607;91;1993;21;70;16;3;2650;1082;2.449168;5;113;1642;34.1;560;2653
1608;91;1994;27;90;11;4;2898;1174;2.468484;16;233;1712;31.43;538;2902
1609;91;1995;30;96;19;4;3081;1247;2.47073;11;172;1802;30.8;555;3085
1610;91;1996;25;108;17;4;3248;1316;2.468085;8;159;1898;30.66;582;3252
1611;91;1997;31;58;17;4;3318;1348;2.461424;14;56;2006;32.8;658;3322
1612;91;1998;35;67;17;4;3449;1397;2.468862;18;113;2064;32.32;667;3453
1613;91;1999;38;68;24;4;3614;1461;2.473648;14;151;2131;31.44;670;3618
1614;91;2000;26;16;20;18;3757;1592;2.359924623;6;142;2162;26.36;570;3775
1615;91;2001;40;64;25;18;3791;1618;2.343016069;15;19;2233;27.54;615;3809
1616;91;2002;31;88;15;18;3885;1672;2.323564593;16;78;2328;28.18;656;3903
1617;91;2003;31;83;26;18;3887;1685;2.306824926;5;-3;2431;30.69;746;3905
1618;91;2004;35;107;26;18;4005;1748;2.291189931;9;109;2566;31.88;818;4023
1619;91;2005;35;100;23;18;4066;1788;2.274049217;12;49;2688;33.48;900;4084
1620;91;2006;38;88;26;18;4119;1823;2.259462425;12;41;2852;36.08;1029;4137
1621;91;2007;40;65;29;18;4256;1898;2.242360379;11;126;2958;35.84;1060;4274
1622;91;2008;42;61;21;18;4389;1973;2.224531171;21;112;3036;35.01;1063;4407
1623;91;2009;26;35;21;18;4354;1973;2.206791688;5;-40;3066;35.65;1093;4372
1624;91;2010;38;5.25;27;0;4446;2026;2.194471866;11;63;3088;34.39;1062;4446
1625;91;2011;29;20;19;0;4414;2013;2.192747144;10;-42;3107;35.21;1094;4414
1626;91;2012;33;19;20;0;4496;2049;2.194241093;13;69;3126;34.45;1077;4496
1627;91;2013;32;23;33;0;4543;2071;2.193626268;-1;48;3148;34.21;1077;4543
1628;91;2014;34;29;44;0;4565;2082;2.192603266;-10;32;3177;34.47;1095;4565
1629;91;2015;21;33;29;0;4596;2095;2.193794749;-8;39;3208;34.69;1113;4596
1630;91;2016;34;35;34;0;4777;2179;2.192290041;0;181;3241;32.77;1062;4777
1631;91;2017;31;49;22;0;4795;2186;2.193504117;9;9;3289;33.54;1103;4795
1632;91;2018;23;49;35;0;4804;2267;2.119100132;-12;21;3360;32.53;1093;4804
1633;93;1985;101;228;31;14;6587;2178;3.024334;70;-229;6600;67;4422;6601
1634;93;1986;122;183;25;15;6845;2245;3.048998;97;162;6826;67.11;4581;6860
1635;93;1987;95;131;41;14;6923;2248;3.079626;54;23;7007;67.92;4759;6937
1636;93;1988;101;122;35;14;6879;2213;3.10845;66;-110;7145;69.03;4932;6893
1637;93;1989;90;109;28;14;7040;2251;3.127499;62;99;7163;68.57;4912;7054
1638;93;1990;92;124;27;0;7269;2775;2.619459;65;150;7247;61.71;4472;7269
1639;93;1991;108;97;26;0;7700;2895;2.659758;82;349;7371;60.72;4476;7700
1640;93;1992;83;182;35;0;8092;3078;2.62898;48;344;7468;58.78;4390;8092
1641;93;1993;114;298;34;0;8581;3341;2.568393;80;409;7650;56.33;4309;8581
1642;93;1994;105;426;37;0;9526;3694;2.578776;68;877;7948;53.52;4254;9526
1643;93;1995;146;452;38;0;10577;4114;2.570977;108;943;8374;50.87;4260;10577
1644;93;1996;135;468;42;0;11377;4448;2.557779;93;707;8826;49.6;4378;11377
1645;93;1997;130;446;40;0;12362;4880;2.533197;90;895;9294;47.49;4414;12362
1646;93;1998;147;345;51;0;13065;5168;2.528057;96;607;9740;46.94;4572;13065
1647;93;1999;178;388;43;0;13900;5513;2.521313;135;700;10085;45.33;4572;13900
1648;93;2000;149;105;65;70;14659;5992;2.446428571;84;741;10810;44.57;4818;14729
1649;93;2001;168;422;55;70;15102;6223;2.426803792;113;330;11265;44.76;5042;15172
1650;93;2002;170;380;70;70;15347;6382;2.404732059;100;145;11679;45.35;5297;15417
1651;93;2003;173;338;67;70;15719;6595;2.383472328;106;266;12054;45.29;5459;15789
1652;93;2004;149;292;72;70;15843;6704;2.36321599;77;47;12384;45.87;5680;15913
1653;93;2005;166;313;58;70;15991;6824;2.343347011;108;40;12739;46.43;5915;16061
1654;93;2006;161;281;65;70;16058;6915;2.32219812;96;-29;13063;47.06;6148;16128
1655;93;2007;150;306;71;70;16266;7065;2.302335456;79;129;13412;47.32;6347;16336
1656;93;2008;135;227;71;70;16208;7104;2.281531532;64;-122;13684;48.09;6580;16278
1657;93;2009;149;154;64;70;15901;7033;2.260912839;85;-392;13833;49.16;6800;15971
1658;93;2010;121;26.5;82;92;16170;7200;2.245833333;39;252;13948;48.38;6748;16262
1659;93;2011;117;95;82;92;15949;7101;2.246021687;35;-256;13953;49.11;6852;16041
1660;93;2012;109;73;77;92;15941;7098;2.2458439;32;-40;13956;49.14;6858;16033
1661;93;2013;97;32.02;73;92;16079;7159;2.245984076;24;114;13959;48.71;6800;16171
1662;93;2014;96;57;85;92;16277;7248;2.245722958;11;187;13961;48.08;6713;16369
1663;93;2015;115;89;90;92;16629;7404;2.245948136;25;327;13962;46.97;6558;16721
1664;93;2016;118;122;98;92;17262;7686;2.245901639;20;613;13963;44.95;6277;17354
1665;93;2017;113;137;101;92;17814;7932;2.245839637;12;540;13964;43.2;6032;17906
1666;93;2018;124;154;99;92;18464;8221;2.24595548;25;625;13970;41.15;5749;18556
1667;95;1985;61;3;60;59;4362;1794;2.431438;1;-10;2118;15.3;324;4421
1668;95;1986;73;6;47;59;4386;1828;2.399343;26;-2;2131;14.22;303;4445
1669;95;1987;45;4;56;59;4352;1834;2.372955;-11;-23;2147;14.58;313;4411
1670;95;1988;54;0;37;59;4273;1821;2.346513;17;-96;2153;15.42;332;4332
1671;95;1989;52;5;51;90;4159;1799;2.31184;1;-84;2114;14.9;315;4249
1672;95;1990;59;6;53;65;4123;1712;2.408294;6;-67;1960;12.65;248;4188
1673;95;1991;56;2;57;67;4142;1789;2.31526;-1;22;1966;9;177;4209
1674;95;1992;46;7;55;69;4162;1830;2.274317;-9;31;1968;7.01;138;4231
1675;95;1993;55;7;56;68;4310;1798;2.397108;-1;148;1975;8.96;177;4378
1676;95;1994;48;6;76;69;4332;1806;2.398671;-28;51;1982;8.88;176;4401
1677;95;1995;52;8;37;70;4409;1841;2.394894;15;63;1988;7.39;147;4479
1678;95;1996;70;15;52;70;4434;1863;2.380032;18;7;1996;6.66;133;4504
1679;95;1997;51;19;55;71;4503;1910;2.357592;-4;74;2011;5.02;101;4574
1680;95;1998;61;14;64;71;4499;1912;2.353034;-3;-1;2030;5.81;118;4570
1681;95;1999;58;20;46;71;4447;1895;2.346702;12;-64;2044;7.29;149;4518
1682;95;2000;64;2;50;89;4363;1771;2.463579898;14;-81;2016;12.15;245;4452
1683;95;2001;52;9;55;89;4398;1790;2.45698324;-3;38;2023;11.52;233;4487
1684;95;2002;58;13;56;89;4407;1797;2.452420701;2;7;2035;11.7;238;4496
1685;95;2003;57;9;53;89;4388;1793;2.447295036;4;-23;2042;12.19;249;4477
1686;95;2004;71;9;63;89;4491;1839;2.442088091;8;95;2049;10.25;210;4580
1687;95;2005;69;13;38;89;4459;1830;2.436612022;31;-63;2059;11.12;229;4548
1688;95;2006;58;9;51;89;4415;1817;2.429829389;7;-51;2067;12.09;250;4504
1689;95;2007;72;8;37;89;4395;1812;2.425496689;35;-55;2073;12.59;261;4484
1690;95;2008;53;6;58;89;4362;1802;2.420643729;-5;-28;2077;13.24;275;4451
1691;95;2009;47;3;44;89;4365;1808;2.414269912;3;0;2083;13.2;275;4454
1692;95;2010;59;1.75;54;60;4405;1828;2.409737418;5;6;2088;12.45;260;4465
1693;95;2011;51;3;61;60;4336;1800;2.408888889;-10;-59;2090;13.88;290;4396
1694;95;2012;55;2;50;60;4351;1806;2.409191584;5;10;2092;13.67;286;4411
1695;95;2013;41;14;49;60;4320;1794;2.408026756;-8;-23;2101;14.61;307;4380
1696;95;2014;65;6;49;60;4330;1828;2.368708972;16;-6;2100;12.95;272;4390
1697;95;2015;57;9;55;60;4266;1818;2.346534653;2;-66;2108;13.76;290;4326
1698;95;2016;68;9;45;60;4225;1804;2.342017738;23;-64;2112;14.58;308;4285
1699;95;2017;53;1;51;60;4232;1808;2.340707965;2;5;2113;14.43;305;4292
1700;95;2018;41;18;55;60;4208;1803;2.333887965;-14;-10;2128;15.27;325;4268
1701;97;1985;144;39;27;21;11295;5458;2.069439;117;420;9432;42.13;3974;11316
1702;97;1986;181;60;33;23;11945;5900;2.024576;148;504;9468;37.68;3568;11968
1703;97;1987;159;99;27;23;12019;6060;1.983333;132;-58;9553;36.56;3493;12042
1704;97;1988;153;112;25;23;12069;6240;1.934135;128;-78;9657;35.38;3417;12092
1705;97;1989;168;162;21;24;12391;6652;1.862748;147;176;9762;31.86;3110;12415
1706;97;1990;132;153;26;120;12571;5877;2.139016;106;170;9837;40.26;3960;12691
1707;97;1991;146;65;32;120;12862;5971;2.154078;114;177;9990;40.23;4019;12982
1708;97;1992;170;104;23;123;13248;6159;2.150999;147;242;10076;38.87;3917;13371
1709;97;1993;128;138;42;130;13931;6439;2.163535;86;604;10183;36.77;3744;14061
1710;97;1994;167;192;38;135;14404;6615;2.177475;129;349;10321;35.91;3706;14539
1711;97;1995;141;92;32;134;14518;6655;2.181518;109;4;10513;36.7;3858;14652
1712;97;1996;144;180;37;132;14421;6599;2.185331;107;-206;10605;37.77;4006;14553
1713;97;1997;150;197;39;133;14654;6730;2.177415;111;123;10785;37.6;4055;14787
1714;97;1998;136;174;30;133;14648;6702;2.185616;106;-112;11165;39.97;4463;14781
1715;97;1999;145;280;29;133;14700;6702;2.193375;116;-64;11339;40.89;4637;14833
1716;97;2000;176;72;43;328;15436;7248;2.129690949;133;804;11901;39.1;4653;15764
1717;97;2001;165;287;48;328;15856;7446;2.129465485;117;303;12117;38.55;4671;16184
1718;97;2002;170;120;32;328;15773;7410;2.128609987;138;-221;12166;39.09;4756;16101
1719;97;2003;166;134;44;328;15947;7492;2.128537106;122;52;12229;38.74;4737;16275
1720;97;2004;155;113;39;328;15749;7401;2.127955682;116;-314;12272;39.69;4871;16077
1721;97;2005;172;118;50;328;15808;7432;2.127018299;122;-63;12356;39.85;4924;16136
1722;97;2006;157;147;35;328;15759;7411;2.12643368;122;-171;12485;40.64;5074;16087
1723;97;2007;166;211;40;328;15908;7485;2.125317301;126;23;12653;40.84;5168;16236
1724;97;2008;162;168;43;328;16345;7703;2.121900558;119;318;12920;40.38;5217;16673
1725;97;2009;171;115;44;328;16725;7889;2.120040563;127;253;12979;39.22;5090;17053
1726;97;2010;141;7.09;38;72;17084;8156;2.094654242;103;0;12960;37.07;4804;17156
1727;97;2011;175;44;53;72;17104;8164;2.095051445;122;-102;13003;37.21;4839;17176
1728;97;2012;128;41;51;72;17228;8222;2.095353928;77;47;13044;36.97;4822;17300
1729;97;2013;124;23;43;72;17397;8304;2.095014451;81;88;13067;36.45;4763;17469
1730;97;2014;132;112;59;72;17650;8427;2.094458289;73;180;13176;36.04;4749;17722
1731;97;2015;127;416;52;72;17874;8554;2.089548749;75;149;13568;36.95;5014;17946
1732;97;2016;146;454.12;65;72;17881;8577;2.084761572;81;-74;14002;38.74;5425;17953
1733;97;2017;163;90.62;49;72;17869;8567;2.085794327;114;-126;14081;39.16;5514;17941
1734;97;2018;119;58.92;73;72;17810;8539;2.085724324;46;-105;14128;39.56;5589;17882
1735;99;1985;318;21;120;163;14211;5205;2.730259;198;-126;6097;14.63;892;14374
1736;99;1986;273;35;126;160;13968;5142;2.716453;147;-393;6133;16.16;991;14128
1737;99;1987;245;-4;148;158;13828;5106;2.708186;97;-239;6183;17.42;1077;13986
1738;99;1988;243;-3;121;169;14062;5208;2.700077;122;123;6188;15.84;980;14231
1739;99;1989;207;-1;115;151;13568;5046;2.688863;92;-604;6180;18.35;1134;13719
1740;99;1990;221;-1;115;186;13051;4984;2.618579;106;-588;5855;14.88;871;13237
1741;99;1991;219;-2;116;183;12775;4934;2.589177;103;-382;5854;15.72;920;12958
1742;99;1992;214;-4;116;155;12950;4914;2.635328;98;49;5852;16.03;938;13105
1743;99;1993;209;0;124;180;13242;4983;2.657435;85;232;5848;14.79;865;13422
1744;99;1994;228;7;105;166;13520;5065;2.669299;123;141;5848;13.39;783;13686
1745;99;1995;214;5;105;214;13609;5091;2.673149;109;28;5855;13.05;764;13823
1746;99;1996;209;14;135;219;13783;5160;2.671124;74;105;5866;12.04;706;14002
1747;99;1997;220;58;104;198;13919;5241;2.655791;116;-1;5947;11.87;706;14117
1748;99;1998;208;54;136;211;14013;5267;2.660528;72;35;6005;12.29;738;14224
1749;99;1999;212;93;124;224;14148;5306;2.666415;88;60;6059;12.43;753;14372
1750;99;2000;240;4;136;300;14153;5306;2.667357708;104;-23;5980;11.27;674;14453
1751;99;2001;269;17;141;300;13809;5213;2.648954537;128;-472;5987;12.93;774;14109
1752;99;2002;247;13;146;300;13711;5217;2.628138777;101;-199;5986;12.85;769;14011
1753;99;2003;242;15;120;300;13522;5181;2.609920865;122;-311;6000;13.65;819;13822
1754;99;2004;204;8;126;300;13356;5157;2.589877836;78;-244;5997;14.01;840;13656
1755;99;2005;233;8;103;300;13210;5137;2.571539809;130;-276;5994;14.3;857;13510
1756;99;2006;187;11;99;300;12908;5058;2.551996837;88;-390;5997;15.66;939;13208
1757;99;2007;189;3;131;300;12472;4925;2.532385787;58;-494;5958;17.34;1033;12772
1758;99;2008;190;10;128;300;12382;4926;2.513601299;62;-152;5951;17.22;1025;12682
1759;99;2009;191;0;146;300;12276;4924;2.493095045;45;-151;5948;17.22;1024;12576
1760;99;2010;186;0.25;123;315;12216;4928;2.478896104;63;-108;5942;17.06;1014;12531
1761;99;2011;142;2;149;315;12172;4909;2.479527399;-7;-37;5945;17.43;1036;12487
1762;99;2012;188;5.9;127;315;12099;4880;2.479303279;61;-134;5951;18;1071;12414
1763;99;2013;167;4.03;118;315;11996;4838;2.479536999;49;-152;5955;18.76;1117;12311
1764;99;2014;145;5;103;315;11741;4735;2.479619852;42;-297;5960;20.55;1225;12056
1765;99;2015;165;4.08;127;315;11624;4688;2.479522184;38;-155;5964;21.4;1276;11939
1766;99;2016;185;5.51;149;315;11637;4692;2.480179028;36;-23;5969;21.39;1277;11952
1767;99;2017;160;6;123;315;11706;4720;2.480084746;37;32;5968;20.91;1248;12021
1768;99;2018;165;3;133;315;11766;4745;2.479662803;32;28;5959;20.37;1214;12081
1769;101;1985;1844;272;1127;2613;119294;46877;2.54483;717;-1205;51045;8.17;4168;121907
1770;101;1986;1781;264;1126;2643;119722;47816;2.503806;655;-197;51414;7;3598;122365
1771;101;1987;1780;308;1205;2975;119863;48558;2.46845;575;-102;51775;6.21;3217;122838
1772;101;1988;1752;274;1192;2149;121588;49946;2.434389;560;339;52116;4.16;2170;123737
1773;101;1989;1625;147;1159;2143;121220;50569;2.397121;466;-840;52635;3.93;2066;123363
1774;101;1990;1771;167;1220;2915;119963;47057;2.549313;551;-1036;50872;7.5;3815;122878
1775;101;1991;1764;160;1242;2982;120504;48190;2.500602;522;86;51039;5.58;2849;123486
1776;101;1992;1805;228;1259;2975;121435;48410;2.508469;546;378;51199;5.45;2789;124410
1777;101;1993;1780;364;1169;3025;123323;48120;2.562822;611;1327;51544;6.64;3424;126348
1778;101;1994;1746;645;1236;3136;125586;48828;2.572008;510;1864;51949;6.01;3121;128722
1779;101;1995;1730;938;1337;3185;127647;49254;2.591607;393;1717;52292;5.81;3038;130832
1780;101;1996;1734;1193;1260;3353;129145;49821;2.59218;474;1192;53330;6.58;3509;132498
1781;101;1997;1739;1139;1359;3467;131327;50909;2.579642;380;1916;54717;6.96;3808;134794
1782;101;1998;1869;1351;1352;3498;133883;51749;2.587161;517;2070;56103;7.76;4354;137381
1783;101;1999;1933;1437;1374;3529;136189;52510;2.593582;559;1778;57454;8.61;4944;139718
1784;101;2000;1927;267;1380;4135;137719;54760;2.514956172;547;1589;59196;7.49;4436;141854
1785;101;2001;2004;1067;1393;4081;139915;55754;2.509506044;611;1531;60453;7.77;4699;143996
1786;101;2002;1985;1353;1482;4185;142296;56821;2.504285387;503;1982;61792;8.04;4971;146481
1787;101;2003;2060;1265;1451;4032;143940;57613;2.49839446;609;882;63222;8.87;5609;147972
1788;101;2004;1946;1249;1526;3974;144746;58060;2.493041681;420;328;64483;9.96;6423;148720
1789;101;2005;1993;1189;1546;3975;145994;58699;2.487163325;447;802;65740;10.71;7041;149969
1790;101;2006;2014;1135;1412;3930;148134;59689;2.481763809;602;1493;66899;10.78;7210;152064
1791;101;2007;2143;1237;1509;4202;150557;60810;2.475859234;634;2061;68087;10.69;7277;154759
1792;101;2008;2167;642;1608;4111;152141;61613;2.46930031;559;934;68803;10.45;7190;156252
1793;101;2009;2038;399;1558;4142;153182;62213;2.462218507;480;592;69140;10.02;6927;157324
1794;101;2010;2070;94.25;1542;4321;155175;63148;2.457322481;528;1644;69614;9.29;6466;159496
1795;101;2011;1865;247;1651;3924;155957;63460;2.45756382;214;171;69854;9.15;6394;159881
1796;101;2012;1878;134.5;1591;4102;156329;63609;2.457655363;287;263;69986;9.11;6377;160431
1797;101;2013;1852;284.14;1622;4067;156668;63749;2.457575805;230;74;70264;9.27;6515;160735
1798;101;2014;1921;185.67;1631;4019;157079;63912;2.457738766;290;73;70439;9.27;6527;161098
1799;101;2015;1874;78.67;1734;4004;158720;64582;2.457650739;140;1486;70508;8.4;5926;162724
1800;101;2016;1851;282;1714;4003;160473;65296;2.457623744;137;1615;70769;7.73;5473;164476
1801;101;2017;1788;282;1785;4121;161862;65860;2.45766778;3;1504;71037;7.29;5177;165983
1802;101;2018;1824;368;1836;4111;163006;66326;2.457648584;-12;1146;71384;7.09;5058;167117
1803;103;1985;127;0;37;261;6329;2071;3.056012;90;-441;3019;31.4;948;6590
1804;103;1986;103;38;30;257;6183;2006;3.082253;73;-223;3024;33.66;1018;6440
1805;103;1987;96;9;37;240;6188;1995;3.101754;59;-71;3052;34.63;1057;6428
1806;103;1988;92;5;38;253;6046;1927;3.137519;54;-183;3066;37.15;1139;6299
1807;103;1989;89;4;30;217;5894;1861;3.167114;59;-247;3027;38.52;1166;6111
1808;103;1990;76;8;38;232;5829;2180;2.673853;38;-88;2803;22.23;623;6061
1809;103;1991;86;10;32;132;5895;2263;2.604949;54;-88;2811;19.49;548;6027
1810;103;1992;70;21;36;172;6008;2310;2.600866;34;119;2809;17.76;499;6180
1811;103;1993;73;22;45;253;6006;2373;2.530973;28;51;2830;16.15;457;6259
1812;103;1994;65;15;39;226;6088;2437;2.498153;26;29;2852;14.55;415;6314
1813;103;1995;72;17;40;242;6161;2512;2.452627;32;57;2867;12.38;355;6403
1814;103;1996;66;14;44;203;6138;2552;2.405172;22;-84;2884;11.51;332;6341
1815;103;1997;59;16;48;152;6170;2629;2.3469;11;-30;2898;9.28;269;6322
1816;103;1998;62;15;45;161;6071;2634;2.30486;17;-107;2914;9.61;280;6232
1817;103;1999;78;18;56;170;5921;2617;2.262514;22;-163;2929;10.65;312;6091
1818;103;2000;65;4;47;232;5737;2299;2.495432797;18;-142;2859;19.59;560;5969
1819;103;2001;66;17;57;232;5648;2270;2.488105727;9;-98;2887;21.37;617;5880
1820;103;2002;67;24;40;232;5704;2299;2.48107873;27;29;2919;21.24;620;5936
1821;103;2003;75;17;35;232;5623;2274;2.472735268;40;-121;2952;22.97;678;5855
1822;103;2004;76;22;47;232;5672;2298;2.468233246;29;20;3004;23.5;706;5904
1823;103;2005;75;38;58;232;5586;2269;2.461877479;17;-103;3052;25.66;783;5818
1824;103;2006;93;47;50;232;5749;2342;2.454739539;43;120;3106;24.6;764;5981
1825;103;2007;100;47;52;232;5861;2392;2.450250836;48;64;3171;24.57;779;6093
1826;103;2008;109;74;43;232;5928;2428;2.441515651;66;1;3253;25.36;825;6160
1827;103;2009;90;62;40;232;6085;2500;2.434;50;107;3292;24.06;792;6317
1828;103;2010;101;6.5;43;235;6382;2626;2.430312262;58;242;3315;20.78;689;6617
1829;103;2011;106;21;40;190;6544;2693;2.430003713;66;51;3338;19.32;645;6734
1830;103;2012;73;16;55;253;6507;2679;2.428891377;18;8;3355;20.15;676;6760
1831;103;2013;81;6;52;256;6444;2652;2.429864253;29;-89;3351;20.86;699;6700
1832;103;2014;70;9;58;256;6347;2612;2.429938744;12;-109;3359;22.24;747;6603
1833;103;2015;83;9;53;256;6224;2561;2.430300664;30;-153;3356;23.69;795;6480
1834;103;2016;75;11;62;256;6175;2541;2.430145612;13;-62;3357;24.31;816;6431
1835;103;2017;67;6;45;241;6096;2508;2.43062201;22;-116;3369;25.56;861;6337
1836;103;2018;82;13;56;272;6036;2484;2.429951691;26;-55;3381;26.53;897;6308
1837;105;1985;240;0;115;279;11267;3959;2.845921;125;68;4879;18.86;920;11546
1838;105;1986;219;5;95;288;11618;4104;2.830897;124;236;4910;16.42;806;11906
1839;105;1987;193;0;115;284;11474;4071;2.818472;78;-226;4949;17.74;878;11758
1840;105;1988;181;36;107;279;11299;4025;2.807205;74;-254;4957;18.8;932;11578
1841;105;1989;195;78;98;262;10847;3887;2.790584;97;-566;4975;21.87;1088;11109
1842;105;1990;154;-3;98;198;10570;3930;2.689567;56;-397;5277;25.53;1347;10768
1843;105;1991;184;29;112;205;10630;4095;2.595849;72;-5;5274;22.35;1179;10835
1844;105;1992;170;18;122;201;10739;4284;2.506769;48;57;5303;19.22;1019;10940
1845;105;1993;182;30;101;207;11004;4143;2.656046;81;190;5321;22.14;1178;11211
1846;105;1994;157;6;109;210;11251;4233;2.657926;48;202;5351;20.89;1118;11461
1847;105;1995;154;113;115;215;11483;4327;2.653802;39;198;5357;19.23;1030;11698
1848;105;1996;159;132;104;218;11602;4386;2.645235;55;67;5470;19.82;1084;11820
1849;105;1997;158;116;131;222;11744;4504;2.60746;27;119;5602;19.6;1098;11966
1850;105;1998;167;97;108;222;11901;4568;2.605298;59;98;5718;20.11;1150;12123
1851;105;1999;166;94;109;242;12047;4636;2.598576;57;109;5815;20.28;1179;12289
1852;105;2000;189;30;113;251;12178;4713;2.583916826;76;65;6026;21.79;1313;12429
1853;105;2001;178;120;132;251;12155;4725;2.572486772;46;-69;6117;22.76;1392;12406
1854;105;2002;175;89;134;251;12158;4747;2.561196545;41;-38;6195;23.37;1448;12409
1855;105;2003;174;86;127;251;12368;4853;2.548526685;47;163;6265;22.54;1412;12619
1856;105;2004;173;98;130;251;12573;4955;2.537436932;43;162;6332;21.75;1377;12824
1857;105;2005;184;97;133;251;12445;4928;2.52536526;51;-179;6439;23.47;1511;12696
1858;105;2006;191;68;119;251;12188;4849;2.51350794;72;-329;6496;25.35;1647;12439
1859;105;2007;147;60;138;251;11916;4763;2.50178459;9;-281;6568;27.48;1805;12167
1860;105;2008;157;47;122;251;11854;4765;2.48772298;35;-97;6614;27.96;1849;12105
1861;105;2009;159;42;125;251;11744;4742;2.476592155;34;-144;6635;28.53;1893;11995
1862;105;2010;166;3.5;125;198;11803;4787;2.465636098;41;-35;6633;27.83;1846;12001
1863;105;2011;150;18.26;122;198;11700;4746;2.465233881;28;-131;6657;28.71;1911;11898
1864;105;2012;130;12.18;127;198;11648;4723;2.466229092;3;-55;6674;29.23;1951;11846
1865;105;2013;150;13.05;129;198;11460;4647;2.466107166;21;-209;6703;30.67;2056;11658
1866;105;2014;149;21.64;113;198;11295;4580;2.466157205;36;-201;6726;31.91;2146;11493
1867;105;2015;127;17.64;131;198;11141;4518;2.465914121;-4;-150;6748;33.05;2230;11339
1868;105;2016;138;14;128;198;11137;4516;2.466120461;10;-14;6765;33.24;2249;11335
1869;105;2017;118;5;134;198;11082;4493;2.46650345;-16;-39;6772;33.65;2279;11280
1870;105;2018;125;23;137;198;11022;4468;2.46687556;-12;-48;6802;34.31;2334;11220
1871;107;1985;222;62;62;126;14070;5596;2.514296;160;-216;9111;38.58;3515;14196
1872;107;1986;206;28;55;125;13738;5546;2.477101;151;-484;9165;39.49;3619;13863
1873;107;1987;181;96;60;126;13736;5615;2.446305;121;-122;9186;38.87;3571;13862
1874;107;1988;199;66;47;126;13639;5647;2.415265;152;-249;9292;39.23;3645;13765
1875;107;1989;220;122;53;129;13821;5805;2.380878;167;18;9291;37.52;3486;13950
1876;107;1990;198;187;50;165;14007;5483;2.554623;148;74;9252;40.74;3769;14172
1877;107;1991;198;130;40;158;14573;5525;2.637647;158;401;9439;41.47;3914;14731
1878;107;1992;171;223;62;153;14996;5533;2.710284;109;309;9569;42.18;4036;15149
1879;107;1993;196;287;71;188;15736;6069;2.592849;125;650;9792;38.02;3723;15924
1880;107;1994;184;448;59;195;16422;6293;2.609566;125;568;10079;37.56;3786;16617
1881;107;1995;169;443;66;210;17044;6495;2.624172;103;534;10527;38.3;4032;17254
1882;107;1996;177;346;56;209;17509;6644;2.63531;121;343;10970;39.43;4326;17718
1883;107;1997;179;300;70;210;17907;6809;2.629902;109;290;11316;39.83;4507;18117
1884;107;1998;179;508;57;263;18343;6886;2.663811;122;367;11616;40.72;4730;18606
1885;107;1999;202;480;70;316;18908;7107;2.660475;132;486;12130;41.41;5023;19224
1886;107;2000;226;128;51;257;19866;8184;2.427419355;175;716;12063;32.16;3879;20123
1887;107;2001;204;512;81;257;20179;8327;2.423321725;123;190;12534;33.56;4207;20436
1888;107;2002;222;275;69;257;20635;8527;2.419960127;153;303;12939;34.1;4412;20892
1889;107;2003;235;221;67;257;20871;8647;2.413390379;168;68;13137;34.17;4489;21128
1890;107;2004;229;313;61;257;21036;8739;2.407140405;168;-3;13443;34.99;4704;21293
1891;107;2005;239;347;68;257;21196;8831;2.40018118;171;-11;13856;36.27;5025;21453
1892;107;2006;249;459;91;330;21556;9001;2.394845017;158;275;14429;37.62;5428;21886
1893;107;2007;258;405;88;337;22078;9240;2.389393939;170;359;14838;37.73;5598;22415
1894;107;2008;267;568;95;337;22594;9484;2.382328132;172;344;15517;38.88;6033;22931
1895;107;2009;260;376;88;337;22988;9673;2.37651194;172;222;16143;40.08;6470;23325
1896;107;2010;247;17.5;90;335;23104;9863;2.342492142;157;-43;16321;39.57;6458;23439
1897;107;2011;228;27;88;338;22918;9783;2.342635183;140;-323;16347;40.15;6564;23256
1898;107;2012;216;21.26;92;305;22968;9803;2.342956238;124;-107;16368;40.11;6565;23273
1899;107;2013;202;36.17;101;337;23267;9931;2.342865774;101;230;16400;39.45;6469;23604
1900;107;2014;208;59.35;103;346;23732;10130;2.342744324;105;369;16455;38.44;6325;24078
1901;107;2015;214;126.9;101;333;24084;10280;2.342801556;113;226;16578;37.99;6298;24417
1902;107;2016;246;98.64;107;343;24457;10439;2.342848932;139;244;16671;37.38;6232;24800
1903;107;2017;229;163;123;321;25004;10672;2.342953523;106;419;16829;36.59;6157;25325
1904;107;2018;193;115;120;321;25359;10825;2.342632794;73;282;16942;36.11;6117;25680
1905;109;1985;73;2;34;17;4383;1397;3.137437;39;-33;2067;32.41;670;4400
1906;109;1986;81;2;41;18;4580;1445;3.16955;40;158;2071;30.23;626;4598
1907;109;1987;87;0;31;18;4767;1482;3.216599;56;131;2075;28.58;593;4785
1908;109;1988;65;14;27;17;4646;1424;3.26264;38;-160;2079;31.51;655;4663
1909;109;1989;75;0;33;16;4623;1400;3.302143;42;-66;2284;38.7;884;4639
1910;109;1990;87;0;31;90;4554;1643;2.771759;56;-51;2306;28.75;663;4644
1911;109;1991;87;0;41;95;4637;1758;2.637656;46;42;2306;23.76;548;4732
1912;109;1992;80;20;35;98;4690;1779;2.636312;45;11;2306;22.85;527;4788
1913;109;1993;85;1;31;96;4730;1766;2.678369;54;-16;2326;24.08;560;4826
1914;109;1994;79;69;31;100;4842;1817;2.664832;48;68;2327;21.92;510;4942
1915;109;1995;62;48;39;110;5160;1958;2.635342;23;305;2396;18.28;438;5270
1916;109;1996;85;67;31;117;5308;2025;2.621235;54;101;2444;17.14;419;5425
1917;109;1997;80;136;37;122;5370;2082;2.579251;43;24;2511;17.08;429;5492
1918;109;1998;86;105;46;122;5436;2130;2.552113;40;26;2647;19.53;517;5558
1919;109;1999;84;119;43;122;5643;2174;2.595676;41;166;2752;21;578;5765
1920;109;2000;85;33;51;36;5947;2331;2.551265551;34;177;3118;25.24;787;5983
1921;109;2001;73;130;47;36;6047;2398;2.521684737;26;74;3244;26.08;846;6083
1922;109;2002;96;103;53;36;6209;2489;2.495578778;43;119;3342;25.55;854;6245
1923;109;2003;97;75;40;36;6243;2526;2.471496437;57;-23;3411;25.95;885;6279
1924;109;2004;84;82;35;36;6204;2527;2.455085081;49;-88;3493;27.66;966;6240
1925;109;2005;74;103;35;36;6248;2572;2.429237947;39;5;3590;28.36;1018;6284
1926;109;2006;99;77;38;36;6205;2580;2.40503876;61;-104;3659;29.49;1079;6241
1927;109;2007;80;72;38;36;6123;2566;2.386204209;42;-124;3736;31.32;1170;6159
1928;109;2008;59;62;48;36;6140;2599;2.362447095;11;6;3791;31.44;1192;6176
1929;109;2009;73;42;47;36;6090;2600;2.342307692;26;-76;3820;31.94;1220;6126
1930;109;2010;65;9.75;47;18;6126;2651;2.310826103;18;0;3853;31.2;1202;6144
1931;109;2011;72;35;37;18;6177;2668;2.315217391;35;16;3886;31.34;1218;6195
1932;109;2012;76;25;29;18;6328;2736;2.312865497;47;104;3910;30.03;1174;6346
1933;109;2013;73;32;32;18;6237;2699;2.310855873;41;-132;3938;31.46;1239;6255
1934;109;2014;55;35;46;18;6193;2683;2.308237048;9;-53;3972;32.45;1289;6211
1935;109;2015;78;32;60;18;6246;2709;2.305647841;18;35;4002;32.31;1293;6264
1936;109;2016;77;29;49;18;6401;2776;2.305835735;28;127;4028;31.08;1252;6419
1937;109;2017;66;54;47;18;6620;2872;2.305013928;19;200;4080;29.61;1208;6638
1938;109;2018;77;93;55;18;6822;2965;2.30084317;22;180;4170;28.9;1205;6840
1939;111;1985;24;0;5;0;763;310;2.46129;19;-174;529;41.4;219;763
1940;111;1986;10;-1;6;0;754;310;2.432258;4;-13;529;41.4;219;754
1941;111;1987;17;2;4;0;811;337;2.406528;13;44;528;36.17;191;811
1942;111;1988;10;-1;0;0;747;313;2.386581;8;-74;531;41.05;218;747
1943;111;1989;7;-1;4;0;746;318;2.345912;3;-4;521;38.96;203;746
1944;111;1990;16;2;3;0;736;287;2.56446;13;-23;481;40.33;194;736
1945;111;1991;14;1;3;0;711;285;2.494737;11;-36;483;40.99;198;711
1946;111;1992;9;4;3;0;574;228;2.517544;6;-142;484;52.89;256;574
1947;111;1993;6;7;5;0;540;202;2.673267;1;-31;488;58.61;286;540
1948;111;1994;7;2;0;0;563;209;2.69378;7;14;495;57.78;286;563
1949;111;1995;10;6;6;0;571;211;2.706161;4;4;497;57.55;286;571
1950;111;1996;6;6;4;0;579;215;2.693023;2;6;503;57.26;288;579
1951;111;1997;5;10;7;0;570;214;2.663551;-2;-9;509;57.96;295;570
1952;111;1998;5;7;3;0;555;207;2.681159;2;-18;519;60.12;312;555
1953;111;1999;8;4;5;0;557;206;2.703883;3;-1;606;66.01;400;557
1954;111;2000;3;1;3;5;556;270;2.059259259;0;9;633;57.35;363;561
1955;111;2001;5;5;3;5;561;273;2.054945055;2;3;639;57.28;366;566
1956;111;2002;5;9;1;5;594;290;2.048275862;4;29;650;55.38;360;599
1957;111;2003;6;14;0;5;610;298;2.046979866;6;10;664;55.12;366;615
1958;111;2004;6;19;3;5;630;308;2.045454545;3;17;685;55.04;377;635
1959;111;2005;6;19;3;5;640;314;2.038216561;3;7;706;55.52;392;645
1960;111;2006;9;20;2;5;667;327;2.039755352;7;20;729;55.14;402;672
1961;111;2007;7;11;4;5;681;335;2.032835821;3;11;741;54.79;406;686
1962;111;2008;5;4;2;5;693;341;2.032258065;3;9;746;54.29;405;698
1963;111;2009;3;7;3;5;682;335;2.035820896;0;-11;752;55.45;417;687
1964;111;2010;3;1;3;0;709;349;2.031518625;0;22;757;53.9;408;709
1965;111;2011;8;1;8;0;691;340;2.032352941;0;-18;758;55.15;418;691
1966;111;2012;3;1;2;0;694;342;2.029239766;1;2;759;54.94;417;694
1967;111;2013;1;6;5;0;692;340;2.035294118;-4;2;765;55.56;425;692
1968;111;2014;7;0;3;0;712;351;2.028490028;4;16;765;54.12;414;712
1969;111;2015;6;0;6;0;689;339;2.032448378;0;-23;765;55.69;426;689
1970;111;2016;5;6;3;0;689;339;2.032448378;2;-2;771;56.03;432;689
1971;111;2017;6;8;5;0;712;350;2.034285714;1;22;779;55.07;429;712
1972;111;2018;3;7;1;0;760;374;2.032085561;2;46;786;52.42;412;760
1973;113;1985;63;156;5;0;3189;1415;2.25371;58;172;2103;32.72;688;3189
1974;113;1986;52;78;12;0;3374;1546;2.182406;40;145;2265;31.74;719;3374
1975;113;1987;47;43;8;0;3463;1619;2.138975;39;50;2350;31.11;731;3463
1976;113;1988;63;56;14;0;3557;1700;2.092353;49;45;2395;29.02;695;3557
1977;113;1989;43;92;8;0;3612;1769;2.041831;35;20;2440;27.5;671;3612
1978;113;1990;57;136;11;56;3676;1489;2.468771;46;74;2635;43.49;1146;3732
1979;113;1991;53;178;10;57;4073;1546;2.634541;43;355;2771;44.21;1225;4130
1980;113;1992;49;169;11;53;4512;1489;3.030222;38;397;2949;49.51;1460;4565
1981;113;1993;51;220;19;65;4799;1920;2.499479;32;267;3123;38.52;1203;4864
1982;113;1994;48;353;8;78;5227;2076;2.517823;40;401;3343;37.9;1267;5305
1983;113;1995;63;113;11;75;5414;2132;2.5394;52;132;3696;42.32;1564;5489
1984;113;1996;64;152;15;78;5726;2239;2.557392;49;266;3809;41.22;1570;5804
1985;113;1997;53;114;14;79;5874;2294;2.560593;39;110;3961;42.09;1667;5953
1986;113;1998;74;178;10;79;6374;2350;2.71234;64;436;4075;42.33;1725;6453
1987;113;1999;56;145;10;79;6454;2476;2.606624;46;34;4530;45.34;2054;6533
1988;113;2000;67;35;13;17;6598;3027;2.17971589;54;30;5231;42.13;2204;6615
1989;113;2001;65;138;15;17;6883;3169;2.171978542;50;235;5392;41.23;2223;6900
1990;113;2002;84;130;13;17;7025;3243;2.166204132;71;71;5555;41.62;2312;7042
1991;113;2003;74;97;24;17;6993;3234;2.162337662;50;-82;5690;43.16;2456;7010
1992;113;2004;78;94;15;17;7010;3248;2.158251232;63;-46;5813;44.13;2565;7027
1993;113;2005;72;126;15;17;7028;3258;2.157151627;57;-39;5930;45.06;2672;7045
1994;113;2006;105;205;21;17;7042;3273;2.151542927;84;-70;6157;46.84;2884;7059
1995;113;2007;96;155;19;17;7259;3397;2.136885487;77;140;6343;46.44;2946;7276
1996;113;2008;118;148;11;17;7287;3416;2.133196721;107;-79;6521;47.62;3105;7304
1997;113;2009;79;120;13;17;7250;3399;2.132980288;66;-103;6583;48.37;3184;7267
1998;113;2010;65;11;20;9;7347;3451;2.128948131;45;44;6659;48.18;3208;7356
1999;113;2011;76;25;18;9;7478;3512;2.129271071;58;73;6683;47.45;3171;7487
2000;113;2012;72;7;31;9;7571;3556;2.129077615;41;52;6690;46.85;3134;7580
2001;113;2013;68;12;25;9;7612;3575;2.129230769;43;-2;6702;46.66;3127;7621
2002;113;2014;69;11;26;9;7729;3632;2.128028634;43;74;6714;45.9;3082;7738
2003;113;2015;68;83;22;9;7831;3674;2.131464344;46;56;6795;45.93;3121;7840
2004;113;2016;68;32;27;9;8014;3762;2.130249867;41;142;6827;44.9;3065;8023
2005;113;2017;68;35;16;9;8036;3771;2.130999735;52;-30;6861;45.04;3090;8045
2006;113;2018;49;68;13;9;8168;3833;2.13096791;36;96;6927;44.67;3094;8177
2007;115;1985;30;0;39;50;2941;1240;2.371774;-9;-201;1519;18.37;279;2991
2008;115;1986;36;0;27;47;2778;1190;2.334454;9;-175;1520;21.71;330;2825
2009;115;1987;31;0;38;47;2746;1195;2.297908;-7;-25;1520;21.38;325;2793
2010;115;1988;35;0;30;47;2747;1213;2.264633;5;-4;1521;20.25;308;2794
2011;115;1989;28;2;39;47;2687;1206;2.228027;-11;-49;1524;20.87;318;2734
2012;115;1990;29;2;22;32;2648;1141;2.320771;7;-61;1414;19.31;273;2680
2013;115;1991;30;2;22;31;2639;1115;2.366816;8;-18;1416;21.26;301;2670
2014;115;1992;30;1;41;31;2598;1115;2.330045;-11;-30;1418;21.37;303;2629
2015;115;1993;19;2;34;31;2618;1122;2.333333;-15;35;1419;20.93;297;2649
2016;115;1994;31;1;47;31;2633;1121;2.348796;-16;31;1421;21.11;300;2664
2017;115;1995;34;0;42;31;2619;1116;2.346774;-8;-6;1422;21.52;306;2650
2018;115;1996;29;2;43;31;2655;1136;2.337148;-14;50;1422;20.11;286;2686
2019;115;1997;29;21;38;31;2700;1163;2.321582;-9;54;1424;18.33;261;2731
2020;115;1998;35;9;47;31;2650;1142;2.32049;-12;-38;1445;20.97;303;2681
2021;115;1999;35;2;35;31;2688;1158;2.321244;0;38;1454;20.36;296;2719
2022;115;2000;30;1;42;57;2687;1166;2.304459691;-12;38;1389;16.05;223;2744
2023;115;2001;33;4;37;57;2637;1152;2.2890625;-4;-46;1396;17.48;244;2694
2024;115;2002;30;2;43;57;2637;1161;2.271317829;-13;13;1401;17.13;240;2694
2025;115;2003;20;0;39;57;2658;1179;2.254452926;-19;40;1402;15.91;223;2715
2026;115;2004;31;1;44;57;2549;1132;2.251766784;-13;-96;1389;18.5;257;2606
2027;115;2005;35;2;49;57;2521;1132;2.227031802;-14;-14;1394;18.79;262;2578
2028;115;2006;21;2;34;57;2458;1113;2.208445642;-13;-50;1399;20.44;286;2515
2029;115;2007;14;1;34;57;2365;1081;2.187789084;-20;-73;1403;22.95;322;2422
2030;115;2008;27;1;33;57;2363;1092;2.163919414;-6;4;1408;22.44;316;2420
2031;115;2009;21;1;31;57;2319;1080;2.147222222;-10;-34;1411;23.46;331;2376
2032;115;2010;21;0.25;36;35;2332;1086;2.14732965;-15;6;1415;23.25;329;2367
2033;115;2011;29;0;41;35;2333;1088;2.144301471;-12;13;1415;23.11;327;2368
2034;115;2012;21;0;38;35;2339;1092;2.141941392;-17;23;1415;22.83;323;2374
2035;115;2013;27;2;29;35;2301;1073;2.1444548;-2;-36;1417;24.28;344;2336
2036;115;2014;26;3;33;35;2294;1070;2.143925234;-7;0;1420;24.65;350;2329
2037;115;2015;24;1;53;35;2339;1090;2.14587156;-29;74;1421;23.29;331;2374
2038;115;2016;29;0;36;35;2368;1105;2.142986425;-7;36;1421;22.24;316;2403
2039;115;2017;20;3;34;35;2284;1064;2.146616541;-14;-70;1425;25.33;361;2319
2040;115;2018;21;2;35;35;2241;1044;2.146551724;-14;-29;1429;26.94;385;2276
2041;117;1985;243;115;25;0;12865;5697;2.258206;218;633;14623;61.04;8926;12865
2042;117;1986;236;183;17;0;13274;5978;2.220475;219;190;14708;59.36;8730;13274
2043;117;1987;188;94;16;0;12406;5693;2.179168;172;-1040;14862;61.69;9169;12406
2044;117;1988;203;113;22;0;12498;5849;2.136775;181;-89;14960;60.9;9111;12498
2045;117;1989;196;150;20;0;12718;6090;2.088341;176;44;15115;59.71;9025;12718
2046;117;1990;207;244;9;55;12885;5295;2.433428;198;24;17091;69.02;11796;12940
2047;117;1991;209;198;13;55;13416;5448;2.462555;196;335;17335;68.57;11887;13471
2048;117;1992;202;298;31;59;13781;5684;2.424525;171;198;17533;67.58;11849;13840
2049;117;1993;203;444;38;62;15132;6014;2.516129;165;1189;17831;66.27;11817;15194
2050;117;1994;211;862;20;69;17038;6678;2.551363;191;1722;18275;63.46;11597;17107
2051;117;1995;200;947;20;71;18199;7055;2.579589;180;983;19500;63.82;12445;18270
2052;117;1996;194;1270;36;75;19321;7429;2.600754;158;968;20447;63.67;13018;19396
2053;117;1997;241;927;39;77;20272;7777;2.606661;202;751;21224;63.36;13447;20349
2054;117;1998;216;1162;30;77;21204;8049;2.634365;186;746;22211;63.76;14162;21281
2055;117;1999;281;488;46;77;22491;8397;2.678457;235;1052;23807;64.73;15410;22568
2056;117;2000;275;194;38;927;24782;10169;2.437014456;237;2904;27457;62.96;17288;25709
2057;117;2001;329;777;44;927;25366;10408;2.43716372;285;299;28741;63.79;18333;26293
2058;117;2002;364;464;41;927;25587;10505;2.435697287;323;-102;28911;63.66;18406;26514
2059;117;2003;346;384;32;927;25779;10588;2.434737439;314;-122;29154;63.68;18566;26706
2060;117;2004;353;397;46;927;25780;10593;2.433682621;307;-306;29282;63.82;18689;26707
2061;117;2005;339;322;46;927;25696;10568;2.431491294;293;-377;29379;64.03;18811;26623
2062;117;2006;367;456;50;927;25912;10660;2.430769231;317;-101;29419;63.76;18759;26839
2063;117;2007;345;422;42;927;26236;10801;2.429034349;303;21;29536;63.43;18735;27163
2064;117;2008;366;437;49;927;26537;10928;2.428349195;317;-16;29646;63.14;18718;27464
2065;117;2009;373;341;47;927;26856;11072;2.425578035;326;-7;29943;63.02;18871;27783
2066;117;2010;287;19.5;51;273;27800;11787;2.358530585;236;54;29861;60.53;18074;28073
2067;117;2011;308;93.09;54;273;27770;11776;2.358186141;254;-284;29952;60.68;18176;28043
2068;117;2012;309;154;57;273;28029;11886;2.358152448;252;7;30103;60.52;18217;28302
2069;117;2013;248;139;53;273;28461;12069;2.358190405;195;237;30238;60.09;18169;28734
2070;117;2014;271;276;67;273;29058;12316;2.359369925;204;393;30509;59.63;18193;29331
2071;117;2015;271;211;69;273;29851;12654;2.359016912;202;591;30714;58.8;18060;30124
2072;117;2016;295;143.44;63;273;30409;12891;2.358932589;232;326;30854;58.22;17963;30682
2073;117;2017;279;306;68;273;30706;13013;2.35964036;211;86;31155;58.23;18142;30979
2074;117;2018;275;475;71;273;30701;13007;2.36034443;204;-209;31624;58.87;18617;30974
2075;119;1985;202;116;62;52;11253;3920;2.870663;140;313;6844;42.72;2924;11305
2076;119;1986;209;242;58;52;11748;4079;2.880118;151;344;7014;41.84;2935;11800
2077;119;1987;191;170;57;52;12406;4284;2.895892;134;524;7309;41.39;3025;12458
2078;119;1988;179;82;52;50;12427;4267;2.912351;127;-108;7488;43.02;3221;12477
2079;119;1989;190;78;53;49;12425;4248;2.924906;137;-140;7503;43.38;3255;12474
2080;119;1990;185;68;61;64;12447;4720;2.637076;124;-87;7565;37.61;2845;12511
2081;119;1991;194;74;73;66;12646;4996;2.531225;121;80;7633;34.55;2637;12712
2082;119;1992;155;189;65;67;13603;5076;2.679866;90;868;7707;34.14;2631;13670
2083;119;1993;143;198;66;77;14658;5680;2.580634;77;988;7896;28.06;2216;14735
2084;119;1994;185;249;73;82;15708;6118;2.567506;112;943;8094;24.41;1976;15790
2085;119;1995;214;264;78;99;16882;6615;2.552079;136;1055;8343;20.71;1728;16981
2086;119;1996;220;533;93;106;18029;7035;2.562758;127;1027;8607;18.26;1572;18135
2087;119;1997;236;368;65;128;18938;7498;2.52574;171;760;9189;18.4;1691;19066
2088;119;1998;203;301;82;128;19544;7777;2.513051;121;485;9557;18.63;1780;19672
2089;119;1999;218;304;73;128;20051;8024;2.498878;145;362;9858;18.6;1834;20179
2090;119;2000;214;90;96;120;20948;8207;2.552455221;118;766;10660;23.01;2453;21068
2091;119;2001;211;359;83;120;21618;8532;2.533755274;128;542;11043;22.74;2511;21738
2092;119;2002;249;203;96;120;21869;8694;2.515412928;153;98;11285;22.96;2591;21989
2093;119;2003;232;229;93;120;22098;8853;2.496103016;139;90;11532;23.23;2679;22218
2094;119;2004;219;206;95;120;22098;8918;2.477909845;124;-124;11778;24.28;2860;22218
2095;119;2005;205;275;104;120;22385;9101;2.459619822;101;186;12104;24.81;3003;22505
2096;119;2006;206;195;120;120;22671;9292;2.439840723;86;200;12294;24.42;3002;22791
2097;119;2007;234;160;98;120;23044;9519;2.420842525;136;237;12450;23.54;2931;23164
2098;119;2008;195;137;121;120;22982;9570;2.401462905;74;-136;12583;23.95;3013;23102
2099;119;2009;183;88;124;120;23085;9690;2.382352941;59;44;12619;23.21;2929;23205
2100;119;2010;202;9.05;151;132;23309;9844;2.367838277;51;185;12651;22.19;2807;23441
2101;119;2011;222;36.24;134;132;23204;9799;2.367996734;88;-193;12691;22.79;2892;23336
2102;119;2012;154;62.32;144;132;23280;9831;2.36801953;10;66;12754;22.92;2923;23412
2103;119;2013;165;73.42;125;132;23191;9794;2.367878293;40;-129;12828;23.65;3034;23323
2104;119;2014;195;55.14;174;132;23269;9827;2.367864048;21;57;12884;23.73;3057;23401
2105;119;2015;192;157.23;181;132;23215;9801;2.368635853;11;-65;13037;24.82;3236;23347
2106;119;2016;191;91.28;174;132;23875;10080;2.368551587;17;643;13126;23.21;3046;24007
2107;119;2017;181;132;144;132;24487;10334;2.369556803;37;575;13256;22.04;2922;24619
2108;119;2018;170;110;172;132;24925;10170;2.450835792;-2;440;13373;23.95;3203;25057
2109;121;1985;68;3;61;23;5373;2108;2.548862;7;-155;2555;17.5;447;5396
2110;121;1986;77;2;52;22;5172;2043;2.531571;25;-227;2570;20.51;527;5194
2111;121;1987;75;4;54;22;5165;2050;2.519512;21;-28;2584;20.67;534;5187
2112;121;1988;52;1;46;22;5120;2042;2.507346;6;-51;2591;21.19;549;5142
2113;121;1989;53;2;42;21;4930;1977;2.493677;11;-202;2630;24.83;653;4951
2114;121;1990;58;3;56;34;4770;1915;2.490862;2;-149;2307;16.99;392;4804
2115;121;1991;45;4;69;37;4746;2122;2.236569;-24;3;2310;8.14;188;4783
2116;121;1992;63;2;52;38;4848;2143;2.262249;11;92;2314;7.39;171;4886
2117;121;1993;56;3;52;37;5107;2073;2.463579;4;254;2316;10.49;243;5144
2118;121;1994;60;1;52;37;5184;2107;2.46037;8;69;2319;9.14;212;5221
2119;121;1995;70;12;55;38;5198;2125;2.446118;15;0;2320;8.41;195;5236
2120;121;1996;49;9;58;38;5183;2136;2.426498;-9;-6;2332;8.4;196;5221
2121;121;1997;61;11;52;38;5172;2157;2.397775;9;-20;2341;7.86;184;5210
2122;121;1998;45;17;59;38;5117;2145;2.385548;-14;-41;2352;8.8;207;5155
2123;121;1999;65;8;62;38;4986;2100;2.374286;3;-134;2369;11.36;269;5024
2124;121;2000;46;4;53;39;4897;1995;2.454636591;-7;-79;2312;13.71;317;4936
2125;121;2001;48;16;43;52;4847;1984;2.443044355;5;-42;2332;14.92;348;4899
2126;121;2002;40;10;65;161;5098;2097;2.431092036;-25;385;2345;10.58;248;5259
2127;121;2003;57;15;49;161;4979;2058;2.419339164;8;-127;2364;12.94;306;5140
2128;121;2004;38;11;57;222;4838;2010;2.406965174;-19;-61;2379;15.51;369;5060
2129;121;2005;45;4;47;222;4773;1992;2.396084337;-2;-63;2386;16.51;394;4995
2130;121;2006;45;6;57;222;4759;1998;2.381881882;-12;-2;2394;16.54;396;4981
2131;121;2007;42;9;38;222;4705;1984;2.371471774;4;-58;2407;17.57;423;4927
2132;121;2008;43;7;53;222;4580;1941;2.359608449;-10;-115;2418;19.73;477;4802
2133;121;2009;44;1;44;222;4555;1940;2.347938144;0;-25;2427;20.07;487;4777
2134;121;2010;54;1.75;41;344;4471;1912;2.338389121;13;25;2435;21.48;523;4815
2135;121;2011;40;5;53;184;4411;1886;2.338812301;-13;-207;2437;22.61;551;4595
2136;121;2012;40;1;50;184;4350;1861;2.337452982;-10;-51;2438;23.67;577;4534
2137;121;2013;35;1;42;184;4392;1879;2.337413518;-7;49;2438;22.93;559;4576
2138;121;2014;47;2;51;184;4383;1876;2.336353945;-4;-5;2438;23.05;562;4567
2139;121;2015;47;5;50;184;4437;1898;2.33772392;-3;57;2440;22.21;542;4621
2140;121;2016;57;5;66;184;4489;1920;2.338020833;-9;61;2442;21.38;522;4673
2141;121;2017;45;6;39;184;4578;1959;2.336906585;6;83;2444;19.84;485;4762
2142;121;2018;58;8;58;184;4545;1945;2.336760925;0;-33;2447;20.51;502;4729
2143;123;1985;2262;878;830;4514;125886;48812;2.578997;1432;-21;50425;3.2;1613;130400
2144;123;1986;2159;668;840;4562;125187;49446;2.531792;1319;-1970;51309;3.63;1863;129749
2145;123;1987;2143;413;874;4688;126340;50388;2.507343;1269;10;51988;3.08;1600;131028
2146;123;1988;2120;295;806;4406;127474;51212;2.489143;1314;-462;52466;2.39;1254;131880
2147;123;1989;2164;253;841;4526;127341;51760;2.46022;1323;-1336;52759;1.89;999;131867
2148;123;1990;2202;262;843;4160;127786;47470;2.691932;1359;-1280;51138;7.17;3668;131946
2149;123;1991;2270;355;834;4301;131430;48760;2.695447;1436;2349;51400;5.14;2640;135731
2150;123;1992;2298;506;899;4295;135827;49801;2.727395;1399;2992;51756;3.78;1955;140122
2151;123;1993;2322;956;955;4452;141326;50639;2.790853;1367;4289;52262;3.11;1623;145778
2152;123;1994;2326;1158;945;4615;146753;51903;2.827447;1381;4209;53274;2.57;1371;151368
2153;123;1995;2224;1469;926;4556;152617;53305;2.86309;1298;4507;54432;2.07;1127;157173
2154;123;1996;2309;1854;1067;4699;157110;54788;2.867599;1242;3394;55929;2.04;1141;161809
2155;123;1997;2487;2114;1005;4729;162111;56803;2.853916;1482;3549;57764;1.66;961;166840
2156;123;1998;2599;3063;1062;4886;167508;58273;2.874539;1537;4017;59950;2.8;1677;172394
2157;123;1999;2841;3552;1096;5043;172222;63087;2.729913;1745;3126;65316;3.41;2229;177265
2158;123;2000;2998;1007;1053;4977;178099;64025;2.781710269;1945;3864;67366;4.96;3341;183076
2159;123;2001;3245;4029;1210;5031;187451;67408;2.780842037;2035;7371;71809;6.13;4401;192482
2160;123;2002;3447;4115;1178;5050;193925;69750;2.780286738;2269;4224;76236;8.51;6486;198975
2161;123;2003;3651;4113;1224;5048;202109;72733;2.778779921;2427;5755;80488;9.63;7755;207157
2162;123;2004;3895;3562;1217;5037;209032;75257;2.777575508;2678;4234;84557;11;9300;214069
2163;123;2005;3849;3768;1263;5065;218367;78672;2.775663514;2586;6777;88602;11.21;9930;223432
2164;123;2006;4001;3691;1259;5077;226206;81597;2.772234273;2742;5109;92059;11.36;10462;231283
2165;123;2007;4101;2433;1314;5060;233219;84195;2.769986341;2787;4209;94523;10.93;10328;238279
2166;123;2008;4013;1596;1294;5051;239065;86395;2.767116153;2719;3118;95692;9.72;9297;244116
2167;123;2009;3923;837;1314;5057;243902;88253;2.763668091;2609;2234;96177;8.24;7924;248959
2168;123;2010;3799;171.77;1352;5895;248335;89827;2.767642208;2447;2824;96558;6.97;6731;254230
2169;123;2011;3751;721.93;1435;5872;252943;91492;2.767640848;2316;2269;97369;6.04;5877;258815
2170;123;2012;3795;756.91;1456;5847;258280;93399;2.7653401;2339;2973;98267;4.95;4868;264127
2171;123;2013;3815;1237.09;1566;5847;264348;95559;2.766332841;2249;3819;99518;3.98;3959;270195
2172;123;2014;3961;1748.08;1611;4761;271332;98023;2.768044235;2350;3548;100979;2.93;2956;276093
2173;123;2015;4083;2529.38;1732;5031;280078;100963;2.774065747;2351;6665;103249;2.21;2286;285109
2174;123;2016;4256;3087.12;1751;5031;289962;104307;2.779890132;2505;7379;106186;1.77;1879;294993
2175;123;2017;4309;2994.93;1832;5031;300236;107744;2.78913094;2477;7797;109333;1.45;1589;305267
2176;123;2018;4271;3213.73;1880;5179;309071;111000;2.786909045;2391;6592;112857;1.65;1857;314250
2177;125;1985;145;1;95;136;9717;3840;2.530469;50;-132;4343;11.58;503;9853
2178;125;1986;145;3;104;132;9451;3768;2.508227;41;-311;4339;13.16;571;9583
2179;125;1987;125;1;100;131;9303;3740;2.487433;25;-174;4336;13.75;596;9434
2180;125;1988;111;1;115;133;9431;3824;2.466266;-4;134;4343;11.95;519;9564
2181;125;1989;92;1;98;129;9082;3719;2.442054;-6;-347;4300;13.51;581;9211
2182;125;1990;139;1;93;121;8826;3472;2.542051;46;-310;4082;14.94;610;8947
2183;125;1991;128;1;91;121;8890;3494;2.544362;37;27;4083;14.43;589;9011
2184;125;1992;113;3;93;119;8882;3430;2.589504;20;-30;4084;16.01;654;9001
2185;125;1993;107;8;96;124;9042;3551;2.546325;11;154;4092;13.22;541;9166
2186;125;1994;98;8;83;124;9152;3596;2.54505;15;95;4100;12.29;504;9276
2187;125;1995;95;13;105;127;9328;3664;2.545851;-10;189;4108;10.81;444;9455
2188;125;1996;108;19;106;128;9393;3698;2.540022;2;64;4121;10.26;423;9521
2189;125;1997;128;10;114;130;9527;3780;2.52037;14;122;4140;8.7;360;9657
2190;125;1998;139;7;103;130;9669;3810;2.537795;36;106;4150;8.19;340;9799
2191;125;1999;141;14;99;130;9693;3844;2.521592;42;-18;4250;9.55;406;9823
2192;125;2000;92;4;91;135;9680;3791;2.553415985;1;-4;4301;11.86;510;9815
2193;125;2001;144;17;114;146;9685;3802;2.547343503;30;-14;4329;12.17;527;9831
2194;125;2002;119;11;115;210;9737;3834;2.539645279;4;112;4353;11.92;519;9947
2195;125;2003;163;8;107;209;9884;3903;2.532410966;56;90;4372;10.73;469;10093
2196;125;2004;140;9;104;207;9678;3830;2.52689295;36;-244;4392;12.8;562;9885
2197;125;2005;142;2;105;205;9687;3843;2.520686963;37;-30;4406;12.78;563;9892
2198;125;2006;153;1;112;216;9701;3857;2.515167228;41;-16;4417;12.68;560;9917
2199;125;2007;148;5;89;221;9660;3850;2.509090909;59;-95;4435;13.19;585;9881
2200;125;2008;159;0;121;219;9676;3866;2.502845318;38;-24;4446;13.05;580;9895
2201;125;2009;166;4;90;217;9819;3934;2.495932893;76;65;4457;11.73;523;10036
2202;125;2010;128;0;92;196;9836;3947;2.492019255;36;-40;4466;11.62;519;10032
2203;125;2011;155;5;118;196;9921;3981;2.492087415;37;48;4469;10.92;488;10117
2204;125;2012;157;6;112;196;9892;3969;2.492315445;45;-74;4474;11.29;505;10088
2205;125;2013;140;4;92;233;9924;3983;2.491589254;48;21;4477;11.03;494;10157
2206;125;2014;142;5;78;229;9976;4004;2.491508492;64;-16;4484;10.7;480;10205
2207;125;2015;142;10;97;229;9847;3985;2.471016311;45;-174;4496;11.37;511;10076
2208;125;2016;145;8;100;234;9867;3993;2.47107438;45;-20;4504;11.35;511;10101
2209;125;2017;145;3;115;234;9803;3978;2.46430367;30;-94;4509;11.78;531;10037
2210;125;2018;134;1;99;234;9792;3975;2.463396226;35;-46;4508;11.82;533;10026
